,bedrooms,bathrooms,sqft_living,floors,grade,sqft_above,sqft_basement,lat,sqft_living15
0,4,4.5,5420,1.0,11,3890,1530,47.6561,4760
1,3,2.5,1890,2.0,7,1890,0,47.3684,2390
2,4,3.0,2950,2.0,9,1980,970,47.5714,2140
3,2,1.0,1200,1.0,7,1200,0,47.3089,1060
4,4,1.75,1620,1.0,7,860,760,47.7025,1400
5,5,2.5,2270,2.0,8,2270,0,47.3266,2240
6,3,1.75,1520,1.0,7,790,730,47.695,1520
7,4,2.5,2570,2.0,8,2570,0,47.7073,2630
8,3,2.5,2300,1.5,8,1510,790,47.6827,1590
9,4,2.0,2360,2.0,8,2360,0,47.6702,1730
10,4,1.0,1220,1.0,7,890,330,47.3341,1290
11,3,1.0,1570,2.0,7,1570,0,47.6413,1580
12,3,1.0,1280,1.0,6,920,360,47.4485,1340
13,3,2.5,2753,1.0,9,2165,588,47.4041,2680
14,4,2.5,2830,2.0,9,2830,0,47.6597,1950
15,4,2.5,2250,2.0,7,2250,0,47.3663,2250
16,4,3.0,1850,2.0,8,1850,0,47.5059,2270
17,3,1.75,1260,1.0,7,1260,0,47.4366,1290
18,3,1.75,2519,2.0,8,2519,0,47.4428,2500
19,3,1.75,1540,3.0,8,1540,0,47.6765,1580
20,3,2.25,1660,1.0,7,1110,550,47.6113,1440
21,4,2.5,2240,2.0,7,2240,0,47.3378,2221
22,3,1.0,1000,1.0,7,1000,0,47.3621,1010
23,5,3.25,4770,1.0,11,3070,1700,47.6525,3530
24,3,2.0,1260,1.0,7,1260,0,47.7362,1640
25,4,2.0,2750,1.5,7,2250,500,47.7168,1510
26,3,1.75,1790,1.0,7,1090,700,47.3511,1940
27,4,4.0,3430,2.0,10,2390,1040,47.5822,3240
28,2,2.25,1610,2.0,7,1610,0,47.518,1950
29,2,1.75,1030,2.0,7,765,265,47.5394,1030
30,3,1.0,1200,1.0,7,1200,0,47.322,1350
31,3,1.5,1580,1.0,8,1290,290,47.687,1570
32,3,1.5,1580,1.0,8,1290,290,47.687,1570
33,3,2.5,2920,2.0,8,2920,0,47.5814,2370
34,3,2.5,2340,1.0,8,1460,880,47.4431,2250
35,3,1.0,1670,1.5,7,1170,500,47.6878,1240
36,4,2.5,3230,2.0,9,2520,710,47.3183,2640
37,4,2.0,1570,1.0,6,1570,0,47.4965,1880
38,3,2.5,2400,1.0,8,1560,840,47.7728,2340
39,3,2.25,2910,2.0,9,2910,0,47.6897,2700
40,4,2.5,2070,2.0,7,2070,0,47.5319,1970
41,3,1.75,1060,1.0,7,1060,0,47.2761,1420
42,3,3.5,3950,1.5,9,2460,1490,47.697,2480
43,4,3.5,2140,3.0,9,2140,0,47.6734,1540
44,3,1.75,1320,1.0,7,1320,0,47.3257,1550
45,4,2.25,2590,1.0,8,1340,1250,47.7689,1550
46,4,2.25,2030,1.0,8,1380,650,47.5495,2230
47,4,2.5,3670,2.0,9,3670,0,47.7421,2840
48,3,1.0,1430,1.0,7,980,450,47.6873,1450
49,3,1.0,1250,1.0,7,1250,0,47.3255,1680
50,5,3.5,3960,2.0,9,2500,1460,47.525,2640
51,4,1.75,1760,1.0,8,1760,0,47.4715,1730
52,3,2.5,3400,2.0,10,3400,0,47.6012,3400
53,3,2.75,1910,1.0,7,1160,750,47.7319,1710
54,3,2.5,2680,1.0,8,1610,1070,47.7028,2480
55,3,2.0,1370,1.0,7,1370,0,47.7458,1770
56,3,1.75,2160,1.0,7,1670,490,47.3026,1930
57,4,2.5,3880,2.0,10,2570,1310,47.6477,3740
58,3,1.0,1220,1.0,6,1220,0,47.6101,1200
59,3,2.5,1670,2.0,7,1670,0,47.3505,1670
60,4,3.0,2380,1.5,7,1680,700,47.5384,1410
61,4,3.0,2440,2.0,7,2440,0,47.7044,2290
62,4,2.75,3130,2.0,9,2140,990,47.6993,2260
63,5,3.0,4090,1.0,10,2090,2000,47.6627,2540
64,3,1.75,1650,1.0,7,1220,430,47.726000000000006,1540
65,3,2.5,2180,1.0,7,1420,760,47.7606,1900
66,3,1.0,1060,1.0,7,1060,0,47.7481,1570
67,3,2.5,1690,2.0,8,1690,0,47.2779,2550
68,4,2.0,1970,1.5,7,1130,840,47.5511,1500
69,3,1.75,1350,1.0,7,1350,0,47.4058,1560
70,3,1.0,860,1.0,6,860,0,47.5093,1300
71,3,1.5,1300,1.0,7,900,400,47.3025,1430
72,3,2.25,2020,2.0,7,2020,0,47.3828,2020
73,4,2.25,1720,1.0,7,1120,600,47.2922,1510
74,3,2.5,1480,2.0,7,1480,0,47.6794,2250
75,6,2.75,2940,1.0,8,1780,1160,47.3103,2120
76,2,1.0,1430,1.5,7,1430,0,47.6727,1450
77,2,1.0,1030,1.0,7,790,240,47.6779,1390
78,3,2.5,2740,2.0,9,2740,0,47.3076,2570
79,4,2.0,2010,1.0,7,2010,0,47.2785,2010
80,3,2.0,1810,1.0,7,1240,570,47.3656,1750
81,3,2.25,1510,2.0,8,1510,0,47.4616,1730
82,3,2.5,1730,2.0,7,1730,0,47.3507,1630
83,4,1.75,2360,1.0,7,1180,1180,47.5278,1910
84,3,2.25,2100,2.0,10,1320,780,47.6154,2380
85,2,1.0,770,1.0,5,770,0,47.5964,1330
86,1,0.75,760,1.0,5,760,0,47.4683,1230
87,3,2.5,2070,1.0,8,1420,650,47.2988,2070
88,4,3.25,5050,1.5,11,4750,300,47.6312,3890
89,2,1.0,1040,1.0,7,1040,0,47.7107,1440
90,3,1.75,1080,1.0,7,580,500,47.6601,1440
91,3,2.5,2653,2.0,8,2653,0,47.4145,2653
92,3,2.0,2290,1.0,8,2290,0,47.4672,1660
93,4,2.75,3820,2.0,9,2850,970,47.7618,1860
94,3,3.0,2420,1.0,8,1740,680,47.7486,2570
95,3,2.0,1970,2.0,8,1270,700,47.5717,2390
96,4,5.0,4550,1.0,10,2600,1950,47.6053,4550
97,3,2.5,2440,2.0,8,2440,0,47.3494,2510
98,3,1.75,1920,1.0,8,960,960,47.6239,1740
99,4,2.75,1800,1.0,8,1400,400,47.7776,1800
100,2,1.0,1010,1.5,6,1010,0,47.6692,1460
101,5,2.75,3150,2.0,9,3150,0,47.6759,1560
102,3,1.75,1510,1.0,7,1510,0,47.2929,1510
103,2,1.0,1240,1.0,6,960,280,47.4957,1820
104,2,1.0,1240,1.0,6,960,280,47.4957,1820
105,3,2.5,3030,2.0,9,3030,0,47.7721,3080
106,6,1.75,2240,2.0,7,2240,0,47.42,1590
107,4,1.75,2560,2.0,7,2560,0,47.6945,2560
108,4,3.5,3040,2.0,9,2420,620,47.5222,3470
109,3,1.75,2500,1.0,8,1300,1200,47.7222,1580
110,4,1.75,1275,1.0,6,1275,0,47.3796,1660
111,4,2.5,2580,2.0,8,2580,0,47.5374,2380
112,4,1.75,2500,1.0,7,1250,1250,47.7713,2040
113,4,1.5,1550,1.0,7,1050,500,47.3117,1640
114,3,2.5,2440,2.0,9,1980,460,47.565,1520
115,3,2.5,1640,2.0,7,1640,0,47.6359,1580
116,4,2.5,1820,2.0,7,1820,0,47.3845,1820
117,5,2.5,3040,1.0,8,1640,1400,47.5651,2920
118,3,2.0,1840,2.0,7,1840,0,47.4853,1380
119,4,2.5,2990,2.0,9,2990,0,47.4508,2140
120,4,2.25,2180,1.0,7,1100,1080,47.7711,1810
121,4,2.25,2180,1.0,7,1100,1080,47.7711,1810
122,4,2.0,2020,2.0,7,2020,0,47.6831,1910
123,4,2.25,2130,2.0,7,2130,0,47.7237,2300
124,4,2.25,2550,1.0,8,1580,970,47.6283,2420
125,5,2.25,2720,1.0,7,1500,1220,47.5976,2110
126,4,2.0,1940,1.0,8,1940,0,47.5722,2000
127,4,1.75,1530,1.5,7,1530,0,47.4556,1390
128,4,1.75,3730,1.0,7,2150,1580,47.1775,1880
129,3,2.5,1750,2.0,8,1750,0,47.4807,2430
130,4,2.5,1820,2.0,7,1820,0,47.3845,1820
131,4,3.5,2840,1.0,10,2840,0,47.401,3180
132,3,1.75,2910,1.0,7,1530,1380,47.7015,2520
133,2,1.0,950,1.0,7,950,0,47.6885,1320
134,2,1.0,940,1.0,7,940,0,47.6073,1300
135,4,2.0,1440,1.0,7,1200,240,47.7245,1460
136,3,2.5,1490,2.0,7,1490,0,47.4324,1490
137,4,2.5,2450,2.0,8,2450,0,47.7734,2300
138,4,2.5,1710,1.0,9,1440,270,47.559,2140
139,3,2.25,2070,2.0,7,2070,0,47.3417,1890
140,3,1.75,1220,1.0,7,1220,0,47.7736,1630
141,3,2.75,2360,1.0,8,1710,650,47.5698,2120
142,3,2.5,2260,2.0,8,2260,0,47.7356,2350
143,3,1.75,1240,1.0,7,1240,0,47.3663,1490
144,3,2.25,2570,2.0,8,2570,0,47.3759,2400
145,1,0.75,430,1.0,4,430,0,47.6499,1200
146,4,2.5,1850,2.0,8,1850,0,47.3701,2100
147,2,2.0,1610,2.0,6,1610,0,47.4855,1310
148,3,4.25,3840,2.0,10,3840,0,47.6336,3230
149,3,2.5,1610,2.0,9,1080,530,47.5674,1610
150,3,1.5,1050,1.0,7,850,200,47.6943,1770
151,4,2.75,2910,1.0,8,1780,1130,47.6658,2920
152,4,1.75,1700,1.0,7,850,850,47.5772,1620
153,3,2.0,1680,1.0,7,1680,0,47.4734,1680
154,3,1.75,1300,1.0,7,1300,0,47.3811,1300
155,3,2.5,2120,2.0,7,2120,0,47.5322,2530
156,4,2.5,3180,2.0,9,3180,0,47.5416,3030
157,3,2.0,1930,1.0,8,1930,0,47.3672,2200
158,3,1.5,1670,1.0,7,1670,0,47.4404,1930
159,2,1.75,1330,1.0,7,1330,0,47.4467,1450
160,4,1.75,2430,1.0,8,1580,850,47.7206,1980
161,3,1.75,1900,1.0,7,950,950,47.5789,1770
162,2,1.0,1100,1.0,7,1100,0,47.7439,1460
163,3,2.5,2400,2.0,9,2400,0,47.6734,2080
164,4,3.25,3180,2.0,10,3180,0,47.4711,2200
165,3,1.0,1190,1.0,6,1190,0,47.452,1190
166,4,1.0,1590,1.5,6,1590,0,47.7315,1320
167,3,1.5,1010,1.0,7,1010,0,47.4097,1400
168,3,2.5,5403,2.0,12,5403,0,47.4169,3980
169,4,2.5,1560,2.0,7,1560,0,47.5025,1560
170,4,1.75,2320,1.0,8,2270,50,47.3644,2120
171,2,1.0,1320,1.0,6,1320,0,47.4949,1190
172,3,1.75,2180,1.0,7,1140,1040,47.5885,2180
173,3,3.0,4380,2.0,10,3580,800,47.6452,3080
174,2,1.0,750,1.0,6,750,0,47.4727,1340
175,4,2.25,2340,1.0,8,2340,0,47.2953,2340
176,3,2.5,2870,2.0,9,2870,0,47.6935,1630
177,3,1.75,2080,1.0,7,1370,710,47.5846,1870
178,3,1.0,1180,1.5,8,1180,0,47.6376,1440
179,4,2.5,1830,2.0,7,1830,0,47.3572,1830
180,5,3.0,2560,1.5,7,1760,800,47.5502,1080
181,5,2.75,2550,1.5,8,2550,0,47.6136,1590
182,4,2.5,2320,2.0,8,2320,0,47.7727,2450
183,4,2.25,2060,2.0,7,2060,0,47.7258,2060
184,3,2.5,2160,1.5,8,1960,200,47.6045,2160
185,3,1.5,1830,1.0,7,1010,820,47.6277,2450
186,3,2.5,1610,2.0,8,1610,0,47.4489,1610
187,4,2.0,2420,1.0,9,2420,0,47.3131,2560
188,3,2.25,1450,2.0,7,1450,0,47.5665,1560
189,4,2.75,3550,1.0,8,2100,1450,47.425,2050
190,2,2.5,1100,3.0,7,1100,0,47.6972,1200
191,3,2.0,1870,1.0,8,1230,640,47.6372,1780
192,3,2.25,1820,1.0,7,1280,540,47.7162,1810
193,3,2.25,1490,2.0,7,1490,0,47.6844,1290
194,3,2.5,2060,1.0,7,1330,730,47.5671,1920
195,3,1.0,990,1.0,6,990,0,47.7125,1440
196,4,2.25,3250,2.0,9,3250,0,47.3496,3110
197,3,1.0,960,1.0,6,960,0,47.1951,1080
198,3,1.75,2080,1.0,7,1600,480,47.5375,1680
199,3,1.5,1360,2.0,7,1360,0,47.4488,1220
200,3,1.75,1760,1.0,7,1150,610,47.3647,1760
201,4,1.0,1260,1.5,6,1260,0,47.5044,1170
202,3,1.0,1920,1.0,7,1120,800,47.5193,2000
203,3,2.5,3930,1.0,8,2330,1600,47.7022,2730
204,3,1.5,1250,1.0,7,1250,0,47.6245,1750
205,3,1.75,1140,1.0,7,1140,0,47.4761,1150
206,3,1.0,1290,1.0,7,1290,0,47.7404,1390
207,3,1.5,1220,3.0,8,1220,0,47.7049,1220
208,4,3.25,3160,2.0,9,2360,800,47.6597,2220
209,3,1.0,2090,1.0,8,1200,890,47.5304,1850
210,3,2.5,2680,2.0,8,2680,0,47.2918,2430
211,4,2.5,2730,2.0,7,2730,0,47.5441,2730
212,3,1.0,1220,1.0,6,1220,0,47.6982,1490
213,5,2.5,4570,2.0,10,4570,0,47.5553,3180
214,4,2.25,2470,2.0,8,2470,0,47.4406,2330
215,3,2.0,1410,1.0,7,1410,0,47.3702,1670
216,3,1.75,1760,1.0,7,920,840,47.3664,1350
217,4,2.25,2240,2.0,8,2240,0,47.5894,2300
218,2,1.0,1380,1.5,5,1380,0,47.5708,1500
219,2,1.0,880,1.0,5,880,0,47.4672,1410
220,3,2.5,3660,2.0,9,3260,400,47.2413,2700
221,4,2.5,2340,2.0,8,2340,0,47.4206,1970
222,2,1.0,960,1.0,7,960,0,47.6893,1300
223,3,1.75,1470,1.0,7,1130,340,47.4818,1590
224,3,2.0,2380,2.0,8,2110,270,47.7591,2030
225,3,2.0,2100,1.0,9,2100,0,47.7479,2290
226,3,1.0,1160,1.0,7,1160,0,47.7422,1160
227,3,1.0,1500,1.0,6,900,600,47.6921,950
228,4,1.75,2010,1.0,7,1300,710,47.5793,2180
229,4,1.5,1510,1.0,7,1070,440,47.7121,1450
230,3,1.0,1370,1.0,7,1230,140,47.5646,1370
231,2,2.5,2380,1.0,8,2380,0,47.717,1870
232,3,1.75,1370,1.0,7,770,600,47.6374,1390
233,3,1.75,1600,1.0,7,1070,530,47.3272,2140
234,5,3.5,3750,1.0,9,2030,1720,47.5511,3270
235,5,1.5,2830,2.5,8,2830,0,47.5132,1480
236,4,2.5,2440,2.0,8,2440,0,47.6333,2560
237,3,2.75,2390,1.0,7,1610,780,47.4987,1920
238,3,2.25,2060,2.0,8,2060,0,47.6216,2160
239,4,2.25,2490,1.0,8,1290,1200,47.6051,2360
240,4,2.5,2640,2.0,8,2640,0,47.4598,2240
241,5,2.0,1940,1.5,7,1940,0,47.7751,1940
242,4,2.0,1910,1.0,7,1060,850,47.6101,1520
243,3,1.0,1250,1.0,7,1250,0,47.475,1450
244,3,1.5,1240,2.0,8,1050,190,47.7073,1180
245,6,2.75,3610,1.5,8,3610,0,47.6261,2560
246,4,2.5,2810,2.0,9,2810,0,47.6337,3100
247,4,1.0,1330,1.5,6,1330,0,47.492,1570
248,4,1.0,1550,1.5,6,1550,0,47.5222,1220
249,3,2.25,1690,2.0,8,1690,0,47.5756,1800
250,3,2.0,1950,1.0,8,1950,0,47.39,2330
251,3,3.25,2660,2.5,8,2660,0,47.3077,1320
252,3,1.5,1150,2.0,7,1150,0,47.5707,1150
253,3,2.0,3010,2.0,9,1890,1120,47.6347,2688
254,3,1.0,1810,1.0,7,1130,680,47.7493,1810
255,3,1.0,1810,1.0,7,1130,680,47.7493,1810
256,3,1.75,2010,1.5,7,1510,500,47.682,1600
257,4,1.0,1300,1.5,6,1300,0,47.4778,1240
258,3,1.0,1340,1.0,7,940,400,47.7321,1020
259,3,1.0,1620,1.5,7,1620,0,47.5719,2440
260,4,3.5,2000,3.0,8,2000,0,47.7027,1440
261,4,2.0,1530,1.5,7,1530,0,47.6645,1860
262,3,1.0,1050,1.0,7,1050,0,47.3841,1610
263,3,2.5,1520,2.0,8,1180,340,47.5446,1270
264,4,2.5,1790,2.0,7,1790,0,47.4829,1950
265,3,2.5,1720,2.0,7,1720,0,47.3898,1570
266,3,1.75,1150,1.0,7,1150,0,47.3729,1330
267,3,3.5,2480,2.0,10,2480,0,47.5951,1980
268,3,1.75,1830,1.0,7,1230,600,47.5962,1950
269,0,0.0,3064,3.5,7,3064,0,47.6362,2360
270,3,1.0,1150,1.0,6,1150,0,47.494,1120
271,5,3.25,2400,2.0,7,1780,620,47.6094,2100
272,3,1.5,1330,1.0,7,1330,0,47.7364,1460
273,3,2.5,2680,2.0,9,2680,0,47.7637,2670
274,3,1.75,1260,1.0,7,1260,0,47.3592,1640
275,3,2.25,1654,2.0,7,1654,0,47.3627,1654
276,5,2.75,2160,1.0,7,1500,660,47.5728,2160
277,4,2.25,2500,1.0,8,1600,900,47.639,2500
278,2,1.0,1000,1.0,6,1000,0,47.527,1100
279,3,1.75,1660,2.0,7,1660,0,47.6903,1520
280,3,2.25,2380,1.0,9,1450,930,47.5371,2750
281,3,1.75,1560,1.5,7,1000,560,47.5666,1430
282,4,3.0,2570,1.0,7,1420,1150,47.4417,2260
283,3,2.5,1320,2.0,7,1320,0,47.5355,1320
284,2,1.0,1060,1.0,6,1060,0,47.7463,1850
285,3,2.5,2020,1.0,7,1310,710,47.3545,1710
286,3,2.25,1580,1.0,7,1580,0,47.5583,1980
287,4,3.0,1490,1.5,7,1490,0,47.5446,1990
288,3,2.5,2020,3.0,8,2020,0,47.6617,1920
289,3,1.0,1350,1.0,6,1350,0,47.7612,2080
290,3,1.75,1570,1.0,7,1300,270,47.4999,1590
291,3,1.0,1320,1.0,7,1320,0,47.3461,1320
292,3,1.75,1560,1.0,7,1250,310,47.7283,1540
293,3,1.25,1510,1.0,6,810,700,47.7289,2560
294,3,1.0,1280,1.0,7,1280,0,47.3298,1420
295,3,1.0,1030,1.0,7,1030,0,47.5364,1270
296,2,1.0,880,1.0,6,880,0,47.7145,1370
297,3,2.5,1360,3.0,7,1310,50,47.6774,1365
298,4,2.5,2160,1.0,8,1660,500,47.6948,1520
299,4,2.0,2780,1.0,8,1190,1590,47.7293,2580
300,2,2.75,1590,1.5,5,1590,0,47.2786,1310
301,2,1.0,1030,1.0,8,1030,0,47.3738,1450
302,3,2.0,1850,1.0,8,1850,0,47.3225,2250
303,3,2.25,1422,2.0,7,1422,0,47.3204,1677
304,3,1.75,2020,1.0,7,1180,840,47.7571,2140
305,2,1.0,1080,1.0,7,1080,0,47.6078,2230
306,3,1.75,1700,1.0,8,1230,470,47.7221,1800
307,4,2.75,3130,2.0,10,3130,0,47.7083,3330
308,3,2.25,1370,2.0,7,1370,0,47.3484,1370
309,3,1.75,1260,1.0,7,1260,0,47.7263,1330
310,3,1.5,1480,1.0,7,1480,0,47.5144,1140
311,4,2.5,1930,2.0,7,1930,0,47.4065,1930
312,2,1.0,870,1.5,6,870,0,47.5849,1190
313,2,1.0,1380,1.0,8,1030,350,47.6382,1380
314,3,1.75,2080,1.0,6,2080,0,47.267,1690
315,4,3.0,3680,1.0,10,2060,1620,47.6327,3140
316,4,2.5,1940,1.0,7,1140,800,47.683,2200
317,3,2.25,1780,1.0,7,1230,550,47.701,1780
318,3,1.75,1560,1.0,7,1560,0,47.6493,2320
319,2,1.75,2040,1.0,7,2040,0,47.4985,1850
320,3,1.75,1930,1.0,9,1230,700,47.6582,2300
321,4,3.25,3440,2.0,10,3440,0,47.6476,3440
322,4,2.25,2400,1.5,7,1460,940,47.6763,1250
323,3,1.75,1670,1.0,7,1270,400,47.6416,1460
324,4,2.25,1910,1.0,8,1280,630,47.7259,1860
325,3,1.75,1560,1.0,8,1560,0,47.5197,2200
326,2,1.75,1500,1.0,7,1500,0,47.3643,1220
327,4,2.75,2840,1.0,9,1640,1200,47.5271,2790
328,1,1.0,730,1.0,4,730,0,47.467,1790
329,3,1.0,1050,1.5,7,1050,0,47.7071,1380
330,3,2.5,2380,1.0,9,1340,1040,47.5262,2560
331,2,1.0,1060,1.0,7,860,200,47.6231,1060
332,3,1.75,2300,1.0,8,1310,990,47.477,1160
333,4,3.0,2010,1.0,7,1090,920,47.5042,1470
334,3,1.0,1040,1.0,6,1040,0,47.7565,1140
335,3,2.75,3410,1.5,8,3410,0,47.4497,2260
336,5,1.75,2690,1.0,7,1420,1270,47.5831,2600
337,4,1.5,2810,1.0,8,1490,1320,47.5252,2240
338,4,2.5,3160,2.0,9,3160,0,47.6699,3000
339,2,2.75,1910,3.0,9,1910,0,47.6544,1910
340,4,2.5,2960,2.0,9,2960,0,47.3603,2960
341,4,3.25,3030,2.0,8,3030,0,47.5747,2360
342,3,1.75,1520,1.0,7,1520,0,47.6054,1760
343,4,2.5,1560,2.0,7,1560,0,47.514,1160
344,5,4.5,4300,2.0,10,4300,0,47.5557,3950
345,4,1.75,2020,1.0,7,1010,1010,47.5008,1650
346,5,1.5,2550,1.0,7,1560,990,47.5014,1380
347,5,1.5,2550,1.0,7,1560,990,47.5014,1380
348,3,2.5,3000,1.0,8,1760,1240,47.6191,2040
349,3,1.0,1020,1.0,6,1020,0,47.2093,1420
350,2,2.0,1310,2.0,6,1310,0,47.3496,1310
351,3,2.5,2570,2.0,9,2570,0,47.7408,2490
352,4,2.0,1770,1.5,7,1770,0,47.5916,1710
353,4,2.75,3190,2.0,10,3190,0,47.5862,2850
354,3,2.5,1860,2.0,8,1860,0,47.5703,1840
355,4,2.5,2430,2.0,8,2430,0,47.7402,2260
356,2,1.0,880,1.0,7,880,0,47.6868,1370
357,4,2.5,1930,1.0,7,1330,600,47.7407,1470
358,4,2.5,3230,2.0,10,3230,0,47.4856,2990
359,4,1.75,2460,1.0,7,1410,1050,47.5105,2300
360,5,3.5,2390,2.0,7,2390,0,47.3737,1140
361,3,1.75,1570,1.0,7,1570,0,47.76,1860
362,2,0.75,440,1.0,5,440,0,47.4339,880
363,4,2.0,2440,1.0,7,1220,1220,47.4142,1370
364,3,2.0,1500,2.0,8,1500,0,47.6748,1550
365,4,2.5,3060,2.0,9,3060,0,47.5393,3240
366,4,1.0,1440,1.0,7,1440,0,47.4325,1440
367,3,1.75,1150,1.0,7,1150,0,47.6503,1200
368,3,1.0,960,1.0,7,960,0,47.3335,1250
369,3,2.5,1260,3.0,8,1260,0,47.6277,1340
370,4,1.75,1760,1.0,7,920,840,47.679,1680
371,3,1.0,1170,1.0,7,870,300,47.6584,1240
372,3,2.5,1600,2.0,7,1600,0,47.386,1520
373,2,1.0,770,1.0,7,770,0,47.2997,1480
374,4,2.5,1570,1.0,7,800,770,47.7757,1340
375,3,1.5,1200,1.0,7,1200,0,47.3434,1350
376,2,1.0,790,1.0,6,790,0,47.4413,1930
377,2,1.0,790,1.0,6,790,0,47.4413,1930
378,7,3.0,2800,1.0,7,1400,1400,47.5102,2150
379,2,1.0,1840,1.0,6,1840,0,47.7694,2550
380,4,2.5,3030,3.0,9,3030,0,47.6781,1080
381,4,2.5,1980,2.0,8,1980,0,47.6492,1400
382,4,2.5,3690,2.0,10,3690,0,47.5872,3600
383,3,1.75,2000,1.0,7,1110,890,47.6859,1750
384,3,2.0,1760,1.0,7,1060,700,47.4528,1680
385,3,1.75,2270,1.0,8,1330,940,47.3077,2090
386,4,2.5,1720,2.0,8,1720,0,47.3286,2360
387,4,2.5,2150,2.0,9,2150,0,47.7227,2450
388,3,1.75,1620,1.0,7,980,640,47.6886,1400
389,4,2.5,2680,1.0,7,1530,1150,47.4132,1920
390,3,1.75,2300,1.0,8,1770,530,47.7599,2030
391,3,2.5,2470,2.0,7,2470,0,47.514,2470
392,3,1.0,1250,1.0,7,1250,0,47.7502,1410
393,3,3.5,3110,1.0,10,3110,0,47.6178,3110
394,4,2.75,2440,2.0,7,2440,0,47.4117,2280
395,3,1.0,1130,1.0,7,880,250,47.6973,2190
396,3,1.0,1370,1.0,7,1150,220,47.5617,1460
397,5,2.5,3840,2.0,11,3840,0,47.2996,3270
398,3,1.0,1180,1.0,7,1180,0,47.4551,1460
399,3,1.75,1650,1.0,7,1100,550,47.3187,1280
400,5,2.25,2100,1.0,8,1600,500,47.6737,2100
401,4,3.75,2452,2.0,7,2452,0,47.4744,1180
402,5,2.75,3040,2.0,10,3040,0,47.5531,2860
403,5,3.0,3230,1.5,8,2000,1230,47.7053,1509
404,4,1.75,2350,1.0,8,2350,0,47.5904,3050
405,4,1.0,2000,1.5,7,1250,750,47.5529,1140
406,4,2.5,2160,2.5,9,2160,0,47.6106,1720
407,3,2.0,1970,1.0,7,1070,900,47.4674,1890
408,4,1.0,1200,1.5,7,1200,0,47.7529,1350
409,3,1.75,2000,1.0,8,1120,880,47.6925,2140
410,3,2.0,2310,2.0,9,1560,750,47.648,2000
411,5,4.25,4640,2.0,8,2860,1780,47.6393,3140
412,3,2.25,2330,2.0,8,2330,0,47.6386,2050
413,2,1.75,1250,1.0,7,790,460,47.6795,1500
414,3,2.5,1981,2.0,8,1981,0,47.3668,1981
415,4,2.5,2440,2.0,9,2440,0,47.5744,2820
416,2,1.0,1120,1.0,6,1120,0,47.4979,1270
417,5,3.0,2920,2.0,8,2140,780,47.654,1620
418,2,1.0,1550,1.5,7,1550,0,47.407,1520
419,1,1.0,640,1.0,5,640,0,47.6976,1270
420,4,3.5,2680,2.0,8,2040,640,47.726000000000006,1530
421,3,2.5,2120,2.0,9,2120,0,47.5477,2290
422,1,0.75,1170,1.0,7,880,290,47.2653,1130
423,2,1.0,1050,1.0,7,850,200,47.6767,1850
424,2,1.0,1130,1.0,7,1130,0,47.5141,860
425,4,2.75,3410,2.0,9,3410,0,47.4054,2580
426,4,4.0,5320,2.0,11,5320,0,47.5852,4640
427,3,2.5,2360,2.0,8,2360,0,47.5471,2480
428,4,2.5,2740,2.0,9,2740,0,47.6962,2880
429,3,2.0,1650,1.0,7,1650,0,47.2904,1870
430,2,2.5,1770,2.0,8,1770,0,47.7345,2410
431,4,2.5,4040,1.0,9,2020,2020,47.6408,3160
432,2,1.0,760,1.0,6,760,0,47.5466,1640
433,5,4.75,3830,1.0,8,2130,1700,47.7597,2750
434,3,2.0,2040,1.0,7,1120,920,47.5959,2120
435,3,1.75,1620,1.0,7,1090,530,47.7148,1380
436,3,1.0,1760,1.5,6,1760,0,47.6598,1320
437,3,1.0,1200,1.0,7,1200,0,47.7362,1330
438,3,2.5,2090,2.0,9,2090,0,47.68600000000001,2520
439,2,1.0,1010,1.0,6,1010,0,47.771,1610
440,2,1.0,1010,1.0,6,1010,0,47.771,1610
441,3,1.75,1860,1.0,7,1160,700,47.3855,1490
442,4,2.0,1330,1.0,5,1330,0,47.496,1150
443,1,1.0,660,1.0,6,660,0,47.5723,1560
444,3,2.25,2400,1.5,7,1250,1150,47.6876,1540
445,3,2.25,3020,2.0,9,3020,0,47.6897,2480
446,3,1.75,1050,1.0,7,1050,0,47.4574,1220
447,4,1.75,1730,1.0,8,1730,0,47.6219,2080
448,3,2.5,2380,2.0,9,2380,0,47.6297,2670
449,4,3.5,4210,2.0,9,4210,0,47.6067,3950
450,3,1.0,970,1.0,7,970,0,47.603,1250
451,4,3.0,3470,2.0,9,2370,1100,47.5917,2420
452,5,2.75,2000,2.0,7,2000,0,47.444,1240
453,5,2.5,3890,2.0,10,3890,0,47.7291,3160
454,3,1.0,2280,1.0,8,1250,1030,47.6378,1910
455,3,2.25,2080,1.5,7,1550,530,47.4203,2080
456,3,1.0,970,1.0,6,970,0,47.4167,1280
457,5,2.5,2090,1.0,8,1420,670,47.5968,2490
458,5,3.25,2980,2.5,9,2980,0,47.6919,1670
459,3,2.0,1490,1.0,8,1490,0,47.5455,2190
460,3,1.75,1830,1.0,8,1590,240,47.5038,1670
461,3,1.75,2180,1.0,8,1300,880,47.673,3540
462,4,1.75,1640,1.0,7,820,820,47.6684,1420
463,4,2.5,1820,1.0,7,1220,600,47.4339,1840
464,3,1.0,1120,1.0,7,1120,0,47.7143,1340
465,3,1.0,1800,1.0,7,1040,760,47.68600000000001,1320
466,3,1.75,1530,1.0,7,1530,0,47.3643,1480
467,4,2.5,3010,2.0,9,3010,0,47.6647,2890
468,3,3.25,3680,2.0,9,2340,1340,47.6272,2280
469,3,1.0,1060,1.0,7,1060,0,47.3699,1320
470,3,1.0,1060,1.0,7,1060,0,47.3699,1320
471,4,2.25,2270,1.0,7,1360,910,47.7559,2500
472,3,1.5,1850,1.0,8,1850,0,47.6194,3030
473,4,3.25,4740,2.0,11,4740,0,47.6624,4800
474,4,1.0,1420,1.5,7,1420,0,47.6844,1420
475,4,2.5,2920,1.0,8,1470,1450,47.5947,3210
476,4,1.0,1340,1.5,7,1340,0,47.5658,1900
477,4,2.5,3350,2.0,10,3350,0,47.3432,3350
478,5,2.5,3480,1.0,8,1980,1500,47.4961,2610
479,3,1.75,1100,1.0,7,1100,0,47.3717,1700
480,4,3.0,1920,1.5,8,1540,380,47.5718,1660
481,3,1.0,1550,1.5,6,1550,0,47.5387,1590
482,3,2.0,1760,1.0,7,1760,0,47.3836,2590
483,2,1.0,710,1.0,6,710,0,47.5165,740
484,3,2.75,3010,2.0,10,3010,0,47.4881,1580
485,2,1.75,1340,1.0,6,1340,0,47.4785,1980
486,2,1.0,1530,1.5,7,1530,0,47.6325,2640
487,5,3.5,3550,2.0,9,2550,1000,47.5484,2030
488,4,2.5,2380,1.0,9,2380,0,47.5984,2900
489,3,2.25,1780,1.0,8,1450,330,47.7286,1950
490,3,2.5,1650,2.0,7,1650,0,47.4328,1460
491,2,1.0,1100,1.0,7,1100,0,47.6446,1250
492,3,1.75,2190,2.0,8,2190,0,47.3845,3110
493,4,2.0,2000,2.0,6,1860,140,47.6956,1600
494,3,1.0,990,1.0,7,990,0,47.4887,1460
495,2,1.0,1200,1.0,7,1200,0,47.4832,1200
496,4,2.5,3504,2.0,7,3504,0,47.3012,2790
497,3,3.0,1260,2.0,7,1040,220,47.5943,1780
498,8,5.0,2800,2.0,8,1880,920,47.6086,1800
499,4,2.5,3350,2.0,9,3350,0,47.6506,2620
500,3,2.5,3370,2.0,8,2840,530,47.5442,1500
501,3,2.0,1810,1.0,7,1010,800,47.6273,1810
502,4,2.25,1830,2.0,7,1830,0,47.3679,1870
503,6,2.75,2980,1.5,7,2480,500,47.6684,1470
504,4,1.5,1600,1.0,7,1600,0,47.3107,1540
505,3,1.0,1200,1.0,7,1200,0,47.2043,1210
506,3,1.25,1230,1.5,7,1230,0,47.5301,1310
507,3,1.5,1610,1.0,7,1060,550,47.7674,1540
508,4,3.5,3530,2.0,10,2570,960,47.7073,3170
509,3,1.75,2000,1.0,6,2000,0,47.697,1440
510,2,1.75,1210,1.5,7,1210,0,47.4599,2020
511,3,2.0,1560,1.0,6,1560,0,47.2804,1120
512,4,2.5,3210,2.0,10,3210,0,47.709,3330
513,3,2.5,1782,3.0,7,1782,0,47.7114,1550
514,5,1.75,3690,1.0,9,1890,1800,47.3473,2680
515,4,2.5,2930,2.0,9,2930,0,47.5937,2930
516,4,1.0,1230,1.5,7,1230,0,47.7269,1490
517,3,2.25,1520,1.0,7,1160,360,47.3605,1530
518,3,1.75,3020,2.0,8,3020,0,47.2662,1890
519,3,2.25,1820,2.0,8,1820,0,47.7208,1850
520,4,2.5,2650,2.0,9,2650,0,47.3477,2730
521,3,2.5,1820,1.0,7,1220,600,47.4582,1870
522,3,1.5,1180,1.0,7,1180,0,47.2966,1180
523,3,1.75,1280,1.0,7,1280,0,47.4212,1680
524,3,2.5,2470,2.0,8,2470,0,47.3438,2500
525,6,2.5,2800,1.0,7,1400,1400,47.7735,2290
526,3,2.0,2660,1.0,9,2210,450,47.3689,2660
527,3,2.25,2070,2.0,7,2070,0,47.4617,1550
528,3,2.5,2930,2.0,9,2930,0,47.5151,3720
529,5,1.5,1940,2.0,8,1940,0,47.6845,1750
530,4,2.5,2660,2.0,9,2660,0,47.5449,3010
531,2,1.0,950,1.0,6,810,140,47.6698,1510
532,6,3.75,2940,2.0,7,2940,0,47.5122,1530
533,3,2.25,2240,2.0,9,2240,0,47.6216,2240
534,4,2.5,2710,1.0,8,1700,1010,47.7657,2390
535,4,2.25,2210,2.0,8,2210,0,47.5424,1960
536,4,4.0,3570,2.0,10,2860,710,47.5784,2230
537,4,2.5,3450,2.0,9,3450,0,47.7673,2820
538,4,2.5,3160,1.0,7,1880,1280,47.7368,2070
539,3,1.0,1240,1.0,7,1060,180,47.7115,1429
540,3,1.0,1250,1.5,7,1150,100,47.651,1900
541,4,2.5,2960,2.0,10,2960,0,47.7319,3900
542,2,1.0,840,1.0,6,840,0,47.3069,1010
543,3,1.75,1530,1.0,7,1200,330,47.7768,1530
544,4,2.25,2150,1.0,7,1240,910,47.3045,2050
545,3,1.5,1720,1.5,7,1720,0,47.7535,1590
546,3,2.5,2610,2.0,9,2610,0,47.6654,2610
547,4,2.5,2200,2.0,7,2060,140,47.5726,1660
548,4,3.25,4130,2.0,11,4130,0,47.5208,3720
549,5,2.5,2600,2.0,7,2600,0,47.4324,2180
550,5,1.0,1940,1.0,7,1940,0,47.4407,1380
551,3,1.0,1160,1.0,7,1160,0,47.7507,1800
552,3,2.5,2660,1.0,8,2660,0,47.6042,2660
553,4,2.5,3380,2.0,10,3380,0,47.6292,3390
554,5,1.75,1910,1.0,8,1390,520,47.5333,1820
555,3,2.25,2200,2.0,8,2200,0,47.4522,2170
556,2,1.0,820,1.0,6,820,0,47.5294,1550
557,3,1.75,1790,1.0,7,1040,750,47.3945,1840
558,2,1.0,2020,1.0,7,1700,320,47.506,2020
559,4,2.5,3330,2.0,10,3330,0,47.5526,3360
560,4,2.5,2610,1.5,7,1610,1000,47.6848,1820
561,4,2.75,2610,1.0,8,1760,850,47.5875,2550
562,3,2.0,1840,1.0,8,1840,0,47.4626,2190
563,5,4.5,5620,3.0,11,4700,920,47.6482,2360
564,3,1.75,1520,1.0,7,1140,380,47.7167,1380
565,2,1.0,1450,1.0,7,850,600,47.5293,1190
566,4,2.25,2200,1.0,8,1430,770,47.5653,2420
567,5,2.5,1900,2.0,7,1900,0,47.6273,1900
568,4,2.5,2100,1.5,6,2100,0,47.4787,1340
569,4,2.5,2100,1.5,6,2100,0,47.4787,1340
570,3,2.5,1460,1.0,8,1150,310,47.6955,1550
571,2,1.0,990,1.0,7,990,0,47.7252,1080
572,3,2.0,1700,2.0,7,1700,0,47.6825,1820
573,3,2.5,1630,2.0,8,1630,0,47.4913,1420
574,4,2.5,2280,2.0,7,2280,0,47.4834,2280
575,6,3.75,3010,2.0,9,2000,1010,47.6873,1600
576,3,1.0,1250,1.0,7,1250,0,47.4169,1010
577,3,2.25,2160,1.5,7,1760,400,47.7297,2540
578,4,3.0,2580,2.0,8,2580,0,47.4646,2250
579,3,1.0,2150,1.0,6,2150,0,47.7615,1720
580,4,1.5,1250,1.0,7,960,290,47.7505,1560
581,4,2.5,1850,1.5,7,1210,640,47.6264,1650
582,4,1.0,1660,1.5,7,1260,400,47.6918,1360
583,3,2.0,3030,1.0,7,2100,930,47.5289,1990
584,3,1.75,2250,1.0,8,2250,0,47.3032,1830
585,3,2.5,1710,2.0,7,1710,0,47.6968,1600
586,3,1.75,1530,1.0,8,1530,0,47.545,2060
587,3,2.0,1440,1.0,7,1440,0,47.345,1580
588,5,5.0,5774,1.0,11,4490,1284,47.3466,3260
589,3,2.0,1450,1.5,8,1450,0,47.6726,1450
590,4,3.5,3190,1.5,9,2410,780,47.5846,2840
591,3,1.75,1490,1.0,8,1490,0,47.3817,1740
592,3,1.75,1240,1.0,7,1240,0,47.6108,1370
593,3,2.0,1970,1.0,8,1970,0,47.3744,1970
594,3,2.5,1700,2.0,8,1700,0,47.2615,1940
595,3,1.0,1130,1.5,7,1130,0,47.5491,2280
596,5,3.5,3790,1.0,8,2120,1670,47.4891,1740
597,4,2.25,2020,2.0,7,2020,0,47.483,2120
598,1,0.75,940,1.0,6,940,0,47.7182,1930
599,3,2.5,2390,2.0,9,2390,0,47.6199,2540
600,4,2.5,2440,2.0,9,2440,0,47.5357,2590
601,4,2.5,2600,2.0,10,2600,0,47.3053,2820
602,3,2.0,2080,1.0,7,1040,1040,47.6768,1920
603,3,1.0,1990,1.0,7,1990,0,47.7116,1320
604,6,3.0,2630,1.0,7,1610,1020,47.7166,1220
605,3,1.75,1890,1.0,7,1890,0,47.4156,1500
606,3,1.5,1010,1.0,6,1010,0,47.4925,980
607,2,1.0,1010,1.0,7,1010,0,47.6711,1800
608,4,2.0,1440,1.0,7,1440,0,47.3056,1030
609,3,2.5,2760,2.0,10,2000,760,47.739,2760
610,2,1.0,1350,1.0,7,1350,0,47.4967,1280
611,3,2.5,3110,2.0,9,3110,0,47.4369,2650
612,2,1.0,1290,2.0,7,1290,0,47.6971,1290
613,2,1.0,870,1.0,7,870,0,47.7024,1620
614,4,2.5,2470,2.0,8,2470,0,47.3457,2470
615,5,4.0,3600,1.0,8,1800,1800,47.7022,3600
616,2,1.0,720,1.0,6,720,0,47.7001,840
617,3,1.0,1250,1.0,7,1250,0,47.5956,3060
618,2,2.75,1370,2.0,8,1080,290,47.7053,1370
619,4,2.25,2530,2.0,7,2530,0,47.3939,2650
620,2,1.5,1010,1.5,5,1010,0,47.6757,1760
621,3,1.0,1200,1.0,7,1200,0,47.2021,1300
622,4,3.0,2720,1.0,9,2720,0,47.5833,2640
623,3,2.75,2340,1.0,9,2340,0,47.632,3480
624,4,1.75,1940,1.0,8,1560,380,47.7021,2310
625,3,1.0,1280,1.5,7,1280,0,47.7512,1280
626,3,2.5,1690,2.0,7,1690,0,47.3561,1830
627,2,2.0,1410,1.5,8,1410,0,47.5242,1410
628,3,1.75,1650,1.0,7,1650,0,47.7567,1340
629,3,2.25,1130,2.0,8,1030,100,47.6799,1300
630,5,2.5,2920,2.0,8,2320,600,47.6265,2970
631,4,1.5,1370,1.5,7,1370,0,47.6849,2030
632,2,1.0,950,1.0,6,950,0,47.4909,1820
633,3,2.5,2070,2.0,9,2070,0,47.6256,3300
634,4,4.25,5770,2.0,11,5770,0,47.585,4620
635,3,2.5,1460,2.0,7,1460,0,47.3673,1830
636,4,1.5,1700,1.0,7,1700,0,47.7677,1750
637,2,1.5,1850,1.5,7,1850,0,47.5742,1850
638,4,2.5,2640,2.0,9,2640,0,47.315,1650
639,2,1.0,990,1.0,7,990,0,47.72,1230
640,4,1.0,1530,1.5,7,1530,0,47.6748,1300
641,3,2.0,1790,1.0,7,1390,400,47.4643,1790
642,2,1.5,1590,1.0,7,920,670,47.5831,1900
643,4,1.75,1770,1.0,7,1050,720,47.3646,1410
644,4,2.0,2790,1.0,8,1640,1150,47.5509,2400
645,4,2.5,2790,2.0,9,2790,0,47.6628,2790
646,3,3.75,6400,1.0,10,3810,2590,47.7313,3430
647,3,2.5,1800,2.0,7,1800,0,47.3643,1770
648,3,2.5,1800,2.0,7,1800,0,47.3643,1770
649,3,2.0,2460,1.0,8,1370,1090,47.5215,2150
650,4,2.5,1980,2.0,7,1980,0,47.7158,1980
651,2,1.0,670,1.0,6,670,0,47.53,870
652,4,2.25,1860,1.0,8,1120,740,47.3127,1990
653,2,1.0,520,1.0,5,520,0,47.4799,1572
654,4,1.75,2140,1.0,7,1420,720,47.3096,2040
655,3,2.5,1790,3.0,8,1790,0,47.6726,1450
656,3,1.75,1850,1.0,8,1850,0,47.5608,2220
657,3,2.5,2250,2.0,8,2250,0,47.7489,2080
658,3,1.0,2400,1.0,7,1890,510,47.75,2390
659,4,1.0,1780,1.5,7,1780,0,47.6624,1750
660,3,1.0,1230,1.0,7,1230,0,47.428,1510
661,2,1.0,1088,1.0,6,1088,0,47.2685,1088
662,3,1.0,1190,1.0,7,1190,0,47.7428,1850
663,5,2.75,1940,1.0,7,1240,700,47.4911,1950
664,3,1.75,1400,1.0,8,700,700,47.6508,1370
665,4,1.75,2770,1.0,7,1470,1300,47.6255,1910
666,3,2.75,2690,2.0,10,2690,0,47.5487,2940
667,4,1.0,1340,1.5,7,1340,0,47.489,1620
668,4,2.75,3190,2.0,9,3190,0,47.5898,3159
669,3,2.25,1880,1.0,8,1420,460,47.7623,2300
670,4,2.5,3110,2.0,9,3110,0,47.5408,3110
671,4,2.5,2360,2.0,8,2360,0,47.4052,2280
672,3,2.5,2180,2.0,8,2180,0,47.5723,2120
673,3,2.0,1460,1.0,7,1460,0,47.359,1630
674,4,2.5,3220,2.0,9,3220,0,47.688,3150
675,3,3.0,1820,1.5,8,1620,200,47.6711,1440
676,4,2.5,2820,2.0,9,2820,0,47.3477,2820
677,4,2.0,1570,2.0,7,1570,0,47.3168,1550
678,2,1.0,920,1.0,6,920,0,47.6831,1760
679,3,2.5,1600,2.0,8,1600,0,47.3534,1700
680,4,2.5,2040,2.0,8,2040,0,47.3182,2040
681,5,3.5,3840,2.0,9,3840,0,47.6039,3570
682,4,3.0,2400,1.0,7,1200,1200,47.6466,2670
683,3,1.0,1660,1.0,7,1660,0,47.2159,1660
684,3,2.0,2030,1.0,8,1890,140,47.2953,1870
685,2,1.0,840,1.0,7,840,0,47.5557,1590
686,2,1.0,1260,1.0,7,1260,0,47.6988,1420
687,4,3.75,3450,2.0,10,2570,880,47.692,1880
688,3,1.5,1130,1.0,7,1130,0,47.5041,1130
689,3,1.0,1030,1.0,7,1030,0,47.5281,1030
690,2,1.0,1700,1.0,7,1230,470,47.4131,2040
691,4,2.5,4250,2.0,9,3260,990,47.5578,3690
692,3,2.5,1440,1.0,7,1000,440,47.4042,1680
693,3,1.5,1240,1.0,6,1240,0,47.753,1630
694,4,2.5,1750,2.0,7,1750,0,47.3082,1940
695,3,2.5,1580,2.0,7,1580,0,47.3334,1640
696,5,4.0,6300,2.0,12,4360,1940,47.5922,3260
697,4,2.75,2400,1.0,7,1200,1200,47.7027,1100
698,3,1.5,1300,1.0,7,1300,0,47.2083,1570
699,3,2.0,2560,1.0,8,2560,0,47.295,2360
700,3,1.0,1280,1.0,6,1280,0,47.5724,1630
701,2,1.5,1480,2.0,7,1240,240,47.5439,1550
702,4,2.75,2450,1.0,9,2450,0,47.4268,2650
703,3,1.75,1780,1.0,7,1130,650,47.7628,1660
704,3,1.5,1040,1.0,6,1040,0,47.6793,1010
705,3,1.5,1600,1.0,7,1600,0,47.7109,1600
706,3,1.5,1320,1.0,7,1320,0,47.4267,1530
707,4,2.5,2300,2.0,8,2300,0,47.3813,1860
708,5,3.0,4350,2.0,10,2950,1400,47.6518,3280
709,2,2.0,1680,2.0,7,1680,0,47.3065,1340
710,2,1.0,1340,1.0,7,1340,0,47.7202,1610
711,4,3.25,3960,2.0,10,3960,0,47.5854,3680
712,6,2.0,2650,1.5,8,2650,0,47.5543,1640
713,4,2.75,2850,2.5,9,2530,320,47.6406,2083
714,4,2.0,2850,2.0,8,2490,360,47.5892,2430
715,5,2.25,2700,2.0,9,2700,0,47.6599,2630
716,4,2.5,3060,1.0,8,1810,1250,47.7675,2690
717,2,1.0,740,1.0,6,740,0,47.5172,740
718,3,2.0,1600,1.0,7,990,610,47.6939,1580
719,3,2.0,1550,1.0,7,940,610,47.6379,1880
720,4,2.25,2000,2.0,8,2000,0,47.6852,1610
721,6,5.0,3440,2.0,8,3280,160,47.4871,1400
722,2,1.5,1320,3.0,7,1320,0,47.6704,1320
723,4,2.5,2070,2.0,8,2070,0,47.3487,1950
724,3,1.0,940,1.0,6,940,0,47.6195,1180
725,3,2.0,1830,1.5,7,1290,540,47.573,1530
726,2,1.75,1840,1.0,8,1140,700,47.6875,1540
727,3,1.75,1250,1.0,7,750,500,47.6869,1240
728,2,1.0,1300,1.0,6,1300,0,47.327,1470
729,4,3.0,2760,1.0,8,1760,1000,47.7669,1900
730,6,2.0,2350,2.0,8,2000,350,47.5115,1560
731,5,3.5,5110,2.0,10,3850,1260,47.7261,1790
732,3,2.5,1720,2.0,7,1720,0,47.3391,1340
733,4,2.25,2230,2.0,8,2230,0,47.3769,2420
734,3,2.5,1830,2.0,7,1830,0,47.5003,1610
735,4,3.0,2800,2.0,8,2800,0,47.3542,2800
736,3,2.5,2090,2.0,8,2090,0,47.2735,2320
737,4,2.25,2340,1.0,9,2340,0,47.5377,2340
738,4,2.25,1990,1.0,8,1180,810,47.3258,2030
739,4,2.75,4910,1.0,10,2560,2350,47.6444,3980
740,3,2.25,1700,2.0,7,1150,550,47.6819,1500
741,4,2.25,1990,2.0,8,1990,0,47.667,2320
742,4,2.75,3010,2.0,9,3010,0,47.6979,3010
743,3,1.0,1220,1.0,6,1220,0,47.5297,1100
744,4,2.5,2303,2.0,8,2303,0,47.7266,2080
745,4,1.75,1280,1.0,7,860,420,47.6805,1490
746,5,2.5,2900,2.0,9,2900,0,47.5396,3200
747,3,2.5,1700,2.0,7,1700,0,47.3826,2190
748,3,2.75,1050,1.0,7,1050,0,47.7163,1860
749,4,2.75,2990,1.0,8,1880,1110,47.3357,2790
750,3,1.0,1240,1.0,7,1240,0,47.7542,1550
751,2,2.25,850,2.0,8,850,0,47.7064,850
752,3,1.75,1540,1.0,8,1540,0,47.7152,1710
753,2,2.0,1770,1.0,8,1770,0,47.4287,2090
754,2,1.75,6840,2.5,11,4350,2490,47.6042,3120
755,3,1.0,940,1.0,7,940,0,47.7002,1060
756,5,3.5,3880,2.0,9,2540,1340,47.5696,3690
757,4,1.0,1290,1.0,6,1050,240,47.5223,1060
758,3,2.5,1660,2.0,9,1400,260,47.6268,1820
759,3,1.0,1220,1.0,7,1220,0,47.6326,1420
760,4,2.5,2060,2.0,8,2060,0,47.7168,2060
761,3,1.75,1810,1.0,7,1810,0,47.4581,1620
762,4,1.75,1870,1.0,8,1620,250,47.5938,2060
763,3,1.5,1190,1.0,7,1190,0,47.4887,1390
764,3,2.0,2080,1.0,7,1160,920,47.68600000000001,1330
765,3,1.75,1580,1.0,7,1580,0,47.5256,1580
766,3,1.75,1580,1.0,7,1580,0,47.5256,1580
767,3,1.75,1840,1.0,7,920,920,47.5359,1390
768,3,1.75,1780,1.0,7,1300,480,47.5858,2380
769,2,1.0,700,1.0,6,700,0,47.4924,1030
770,3,2.75,3150,2.0,9,3000,150,47.553,3180
771,4,2.5,2690,2.0,7,2690,0,47.6869,2690
772,6,3.25,3750,2.0,9,2750,1000,47.6999,2140
773,3,1.0,1560,1.5,7,1560,0,47.6118,1660
774,3,1.0,1010,1.0,6,1010,0,47.3781,1190
775,4,2.25,1990,1.0,8,1210,780,47.5688,1720
776,2,1.0,1140,1.0,7,1140,0,47.7448,1030
777,2,1.0,880,1.0,7,880,0,47.6847,1310
778,3,1.0,1040,1.0,6,1040,0,47.3283,1040
779,5,1.75,1830,1.5,7,1610,220,47.7734,1790
780,3,2.5,1440,2.0,7,1440,0,47.6825,1650
781,4,2.5,1580,2.0,7,1580,0,47.3672,1950
782,3,3.25,3230,2.0,9,3230,0,47.5558,2670
783,3,2.5,2495,2.0,8,2495,0,47.2877,2434
784,3,1.0,1030,1.0,7,1030,0,47.4941,1220
785,3,3.0,2330,1.0,9,2330,0,47.7239,2200
786,4,2.5,2980,2.0,8,2980,0,47.277,2610
787,3,2.25,1790,1.0,8,1790,0,47.6297,2290
788,4,2.25,2940,1.0,9,1470,1470,47.6381,2230
789,4,3.0,3900,1.0,10,2520,1380,47.5605,3410
790,4,3.0,3900,1.0,10,2520,1380,47.5605,3410
791,3,2.5,1480,2.0,8,1480,0,47.4723,1480
792,3,1.75,1720,1.0,7,1240,480,47.7329,2530
793,4,3.25,5180,2.0,10,5180,0,47.6676,4240
794,3,2.5,2860,2.0,9,2860,0,47.3163,2370
795,4,2.5,4070,2.0,10,4070,0,47.6908,3890
796,4,2.75,2290,2.0,8,2290,0,47.4442,2000
797,3,2.0,1860,1.0,8,930,930,47.4598,1640
798,3,1.0,960,1.0,7,960,0,47.6805,1140
799,2,1.75,1890,2.0,8,1890,0,47.6144,2180
800,2,1.0,900,1.0,7,900,0,47.6859,1320
801,3,2.0,1600,1.0,7,1600,0,47.5821,1850
802,3,1.75,1500,1.0,6,750,750,47.4883,1500
803,3,2.5,1740,2.0,8,1740,0,47.46,1740
804,4,2.25,2160,1.0,8,2160,0,47.5883,2820
805,3,1.0,1200,1.0,6,1200,0,47.4921,1010
806,4,2.5,2110,2.0,9,2110,0,47.5497,2520
807,3,2.0,1430,1.0,7,1430,0,47.6256,1570
808,3,2.0,3040,1.0,8,1520,1520,47.3944,2230
809,6,2.0,2570,1.5,7,1970,600,47.6754,2030
810,3,2.25,1680,1.0,7,1180,500,47.713,1910
811,3,1.0,1170,1.0,8,1170,0,47.7122,2410
812,3,1.75,1580,1.5,7,1280,300,47.672,1560
813,3,1.5,1270,1.0,7,1270,0,47.4075,1380
814,3,1.75,1480,1.0,8,1480,0,47.7225,1930
815,3,2.25,2220,1.0,8,1700,520,47.6383,2500
816,4,2.75,3200,2.0,11,3200,0,47.6402,4050
817,3,1.75,1480,1.5,8,1480,0,47.6732,2120
818,4,2.5,3780,2.0,10,3780,0,47.6533,3310
819,6,2.75,3600,1.0,9,1940,1660,47.5726,2990
820,3,2.75,2980,1.5,8,1590,1390,47.674,1520
821,5,2.75,2980,1.0,8,1730,1250,47.3774,2900
822,4,1.75,1570,1.0,7,1170,400,47.7432,2080
823,3,2.25,1750,1.0,7,1150,600,47.7509,1820
824,3,2.5,1680,3.0,8,1680,0,47.5891,1740
825,3,1.0,1220,1.0,7,1220,0,47.2811,1420
826,3,1.75,1410,1.0,7,1410,0,47.5375,1560
827,3,1.0,1830,1.0,7,1550,280,47.3126,1810
828,4,2.5,3070,2.0,10,3070,0,47.5847,3630
829,4,2.5,1960,2.0,7,1960,0,47.4941,1960
830,3,2.25,1960,1.0,8,1400,560,47.4436,2060
831,4,2.5,2910,2.0,8,2350,560,47.7085,2020
832,2,1.0,720,1.0,6,720,0,47.5056,1440
833,5,2.0,2060,2.0,7,2060,0,47.6685,1770
834,2,1.5,2440,2.0,7,1590,850,47.5568,1770
835,5,1.0,1460,2.0,6,1460,0,47.487,1060
836,3,1.0,1150,1.0,7,1150,0,47.6788,1410
837,3,1.0,1330,1.0,7,900,430,47.6355,1330
838,3,1.0,1810,2.0,7,1810,0,47.7427,1420
839,3,2.75,3070,2.0,10,2440,630,47.6444,3490
840,3,1.0,1030,1.0,7,1030,0,47.3607,1470
841,3,1.0,1200,1.5,6,1200,0,47.5881,1390
842,4,2.5,1890,2.0,7,1890,0,47.3293,2030
843,6,2.5,3250,1.0,8,1800,1450,47.6935,3490
844,4,1.75,2340,1.0,8,1610,730,47.6401,2470
845,4,2.75,2710,2.0,9,2710,0,47.4745,2710
846,4,2.5,2560,2.0,9,2560,0,47.3474,3040
847,3,2.5,1780,1.0,7,1400,380,47.3667,1520
848,4,2.5,1252,1.0,8,992,260,47.3216,1860
849,4,1.5,1240,1.0,7,1110,130,47.3716,1520
850,3,1.0,1530,1.5,7,1530,0,47.1776,1768
851,3,1.75,2040,1.0,7,1120,920,47.5688,1530
852,4,2.25,2030,2.0,7,2030,0,47.7699,2190
853,3,2.5,2160,2.0,8,2160,0,47.7655,1830
854,4,2.5,2480,2.0,8,2480,0,47.5379,2940
855,3,1.75,1570,1.0,7,1040,530,47.5137,1280
856,4,2.75,3527,2.0,7,3527,0,47.3823,2490
857,5,3.75,3530,2.0,10,3530,0,47.5761,3340
858,2,1.0,1260,1.0,6,1100,160,47.5196,1260
859,2,2.0,2370,1.0,7,2370,0,47.7388,1860
860,4,2.5,1930,2.0,8,1930,0,47.3921,1990
861,3,1.0,1280,1.5,8,1280,0,47.6727,1410
862,4,3.0,2740,1.0,8,1670,1070,47.4538,2330
863,2,3.0,1790,2.0,7,1400,390,47.5926,1460
864,4,1.75,2440,1.0,8,1420,1020,47.6807,2500
865,2,1.0,920,1.0,7,920,0,47.6726,1230
866,2,1.0,1000,1.0,6,1000,0,47.5619,1500
867,3,2.0,1180,2.0,8,1180,0,47.6168,1500
868,4,3.5,3070,2.0,9,2030,1040,47.5732,1780
869,5,3.0,2900,1.0,8,1830,1070,47.6784,2370
870,2,1.0,1680,1.0,7,1140,540,47.55,1610
871,3,1.0,1440,1.0,7,1000,440,47.6968,1540
872,3,2.5,1400,1.0,7,1400,0,47.553,1060
873,2,1.0,1350,1.0,6,950,400,47.6842,1670
874,4,3.0,1670,3.0,8,1427,243,47.6182,1700
875,4,3.25,4030,2.0,9,4030,0,47.6617,3470
876,3,2.25,1630,1.0,7,1100,530,47.7176,1640
877,3,1.75,1990,1.0,7,1100,890,47.664,1460
878,4,2.75,2250,2.0,9,2250,0,47.7353,2450
879,3,2.25,1530,2.0,7,1530,0,47.7342,2110
880,2,1.0,1450,2.0,7,1450,0,47.6853,1450
881,2,1.75,1090,1.0,8,1090,0,47.3782,1360
882,4,1.5,1170,1.0,6,1170,0,47.5495,2380
883,3,2.5,1960,1.0,7,1290,670,47.7249,1960
884,4,2.0,2030,2.0,7,1630,400,47.7056,1350
885,5,3.25,5370,2.0,10,3850,1520,47.6499,2410
886,5,2.5,2670,2.0,9,2670,0,47.7565,1810
887,5,3.5,2790,2.0,10,1970,820,47.4384,2980
888,3,1.0,1200,1.0,6,1200,0,47.5414,1570
889,3,2.0,1380,2.0,7,1380,0,47.4374,1260
890,3,1.75,2240,1.0,7,1440,800,47.2635,1740
891,3,3.0,1430,3.0,8,1430,0,47.6971,1020
892,4,3.5,2630,1.5,7,1640,990,47.4355,1920
893,3,1.75,1710,1.0,7,1110,600,47.6689,920
894,3,1.0,940,1.0,7,940,0,47.4353,1270
895,4,2.75,2380,1.0,8,1680,700,47.5929,1950
896,5,1.75,2140,1.0,8,2140,0,47.3167,1640
897,3,2.75,2550,2.0,8,1980,570,47.7596,2180
898,3,1.0,1080,1.0,7,1080,0,47.7309,1100
899,3,2.25,3070,2.0,10,2110,960,47.5522,3130
900,3,1.5,1050,1.0,7,1050,0,47.5602,1460
901,3,1.0,1210,1.0,7,1210,0,47.7693,1210
902,2,1.0,810,1.0,6,810,0,47.6493,1920
903,4,1.75,1660,1.0,6,1010,650,47.4943,1670
904,3,1.0,1060,1.0,7,1060,0,47.7703,1550
905,1,1.0,820,1.0,8,760,60,47.5473,1770
906,4,1.75,2690,1.5,7,2690,0,47.4951,1920
907,4,2.25,2130,2.0,8,2130,0,47.5672,2550
908,4,2.75,2500,1.0,8,1700,800,47.5901,2650
909,3,1.0,1780,2.0,6,1780,0,47.727,1410
910,4,1.75,1490,1.0,8,1350,140,47.6388,1380
911,3,2.0,1400,2.0,8,1060,340,47.6196,1540
912,3,2.0,1980,1.0,7,1380,600,47.6921,1260
913,3,1.75,1380,1.0,7,860,520,47.6822,1820
914,3,1.75,1590,1.0,7,1590,0,47.4713,1150
915,4,2.5,1470,2.0,7,980,490,47.5275,1460
916,4,3.25,2470,1.5,9,1890,580,47.6331,2470
917,4,2.5,1850,1.0,7,1230,620,47.5386,1010
918,4,2.75,2110,1.5,8,2110,0,47.6269,2420
919,4,5.5,6930,1.0,11,4310,2620,47.5547,2560
920,3,1.0,1340,1.0,7,1040,300,47.6916,1270
921,3,1.5,1560,1.0,7,1560,0,47.4117,1820
922,3,1.0,1310,1.0,7,1310,0,47.4105,1330
923,3,1.0,1310,1.0,7,1310,0,47.4105,1330
924,4,3.5,3930,2.0,12,3930,0,47.6399,4250
925,4,4.25,4070,2.0,10,4070,0,47.59,3430
926,2,1.0,990,1.0,6,990,0,47.6939,990
927,3,1.0,1340,1.0,7,1340,0,47.5771,1430
928,3,2.5,2200,2.0,8,2200,0,47.5319,2400
929,4,1.75,2520,1.0,7,1260,1260,47.3224,2090
930,3,2.0,940,1.0,7,880,60,47.6771,1420
931,4,1.75,2050,1.0,8,1450,600,47.7431,2440
932,2,1.0,2540,1.0,8,1320,1220,47.5259,2160
933,2,2.5,1170,2.0,8,1170,0,47.7041,1350
934,3,1.5,1940,1.5,8,1310,630,47.6205,1940
935,3,2.0,2800,1.0,7,1400,1400,47.7055,2260
936,4,2.0,1640,1.0,7,1640,0,47.7471,1500
937,4,2.0,2030,2.0,7,2030,0,47.4806,1190
938,2,1.0,1120,1.0,7,950,170,47.6496,1510
939,4,2.5,4080,2.0,11,4080,0,47.6344,4080
940,2,1.0,1670,1.0,7,1670,0,47.7152,1670
941,3,1.0,1080,1.0,6,1080,0,47.5515,1380
942,3,1.0,990,1.0,6,990,0,47.3074,1120
943,4,2.5,1720,1.0,7,1120,600,47.2917,1520
944,4,3.0,3180,2.0,9,2070,1110,47.6583,2720
945,3,2.5,2540,1.0,8,1880,660,47.7176,2110
946,1,1.0,570,1.0,5,570,0,47.5098,890
947,3,1.75,2450,1.0,8,1340,1110,47.6536,2280
948,4,2.5,3310,2.0,9,3310,0,47.6649,3010
949,3,1.5,1620,2.0,7,1620,0,47.767,1600
950,3,1.5,1240,1.0,7,1240,0,47.5659,1050
951,0,0.0,1470,3.0,8,1470,0,47.7145,1470
952,3,1.5,1320,1.0,6,1320,0,47.6231,1350
953,4,5.25,6110,2.0,11,6110,0,47.5285,4190
954,4,2.75,2310,1.5,8,1480,830,47.5502,1100
955,2,1.5,1160,2.0,7,890,270,47.7677,1160
956,3,1.75,1120,1.0,7,1120,0,47.4418,1250
957,3,1.5,1410,1.0,7,780,630,47.2914,1440
958,4,1.75,1920,1.0,7,1060,860,47.5747,1840
959,4,1.75,1370,1.0,6,1370,0,47.7572,1650
960,4,1.0,1270,1.5,7,1270,0,47.6135,1420
961,3,2.5,1720,2.0,7,1720,0,47.5426,2220
962,6,3.0,4050,2.0,8,2620,1430,47.4708,3660
963,2,2.75,3690,2.0,12,3690,0,47.4485,2310
964,3,2.5,1840,1.0,8,1340,500,47.7767,1970
965,4,2.25,2550,1.0,7,1560,990,47.77,2440
966,4,2.25,1750,1.5,8,1750,0,47.7612,1750
967,3,1.0,1380,1.0,7,1380,0,47.7164,1610
968,3,1.75,1210,1.5,8,1210,0,47.6621,2020
969,4,1.0,1460,1.0,6,780,680,47.566,1560
970,4,2.0,1720,1.0,7,860,860,47.5734,1280
971,4,1.75,3010,1.0,8,1780,1230,47.707,2040
972,2,1.0,810,1.0,6,810,0,47.489,1440
973,2,1.75,1310,1.0,7,1110,200,47.679,1510
974,3,1.75,1660,1.0,7,1240,420,47.7045,3110
975,4,2.75,2360,1.0,7,1390,970,47.7301,2160
976,3,3.5,3460,2.0,10,3460,0,47.7262,3350
977,4,2.25,2680,2.0,7,2680,0,47.7539,2460
978,2,2.25,1240,2.0,8,1000,240,47.5877,1260
979,3,2.25,1560,1.0,7,1110,450,47.7256,2190
980,3,1.75,1630,1.0,7,1080,550,47.3729,1280
981,5,4.5,2120,2.0,8,2120,0,47.5488,2870
982,1,1.0,790,1.0,7,790,0,47.6178,1580
983,3,1.75,1530,1.0,7,1530,0,47.7629,1580
984,3,3.75,3150,2.0,10,3150,0,47.6387,2510
985,2,1.0,1040,1.0,7,840,200,47.5285,1930
986,3,1.0,1400,1.0,8,1400,0,47.7127,1400
987,3,1.75,1590,1.5,7,1190,400,47.6668,1420
988,3,2.25,1610,1.0,8,1280,330,47.3146,2170
989,3,3.25,3710,2.0,10,3710,0,47.693000000000005,1680
990,4,1.75,2010,1.0,9,2010,0,47.6446,2200
991,2,2.25,2550,2.0,7,1860,690,47.6739,2010
992,5,2.5,2770,2.0,9,2770,0,47.6341,2070
993,3,1.0,1240,1.0,7,1240,0,47.667,2060
994,2,1.75,1640,1.0,7,840,800,47.6645,1980
995,4,3.0,2550,2.0,8,1720,830,47.6786,1590
996,3,1.0,1060,2.0,7,1060,0,47.6615,2010
997,3,1.5,1900,1.5,7,1640,260,47.6779,2090
998,3,1.5,1900,1.5,7,1640,260,47.6779,2090
999,1,1.0,670,1.0,7,670,0,47.5624,1170
1000,3,2.5,2030,2.0,8,2030,0,47.5253,1360
1001,3,1.0,1330,1.0,7,900,430,47.6837,1500
1002,3,1.75,1880,1.0,7,1380,500,47.5116,1970
1003,3,1.5,2520,1.0,8,2520,0,47.4777,1470
1004,2,1.0,800,1.0,7,800,0,47.4075,1490
1005,2,1.5,1295,2.0,9,1105,190,47.6192,1295
1006,2,1.0,910,1.0,7,910,0,47.5427,1060
1007,3,2.5,2450,2.0,8,2450,0,47.3061,1960
1008,6,2.25,4910,2.5,10,3580,1330,47.6458,3280
1009,3,2.0,1570,1.0,7,1570,0,47.3156,1570
1010,3,1.75,2090,2.0,7,1610,480,47.657,1280
1011,3,2.0,2150,1.0,8,2150,0,47.5709,2510
1012,5,2.75,2830,1.0,7,1630,1200,47.5773,2370
1013,3,1.5,1330,1.0,7,1330,0,47.7289,1370
1014,3,1.0,960,1.0,7,960,0,47.5689,1520
1015,5,2.5,3600,1.0,8,2410,1190,47.4468,2620
1016,4,2.5,2750,2.0,7,2750,0,47.3671,2610
1017,4,2.25,2440,1.5,7,2440,0,47.7061,1720
1018,2,2.5,2305,1.0,8,2305,0,47.7203,1440
1019,4,4.5,3890,2.0,11,3060,830,47.5426,4170
1020,5,4.75,5410,2.0,10,5050,360,47.6306,3750
1021,4,2.5,4270,1.0,10,2680,1590,47.6915,3630
1022,3,2.0,2160,1.0,10,2160,0,47.4806,2760
1023,4,1.75,2700,1.0,7,1380,1320,47.2877,2460
1024,4,2.0,2430,1.0,8,1310,1120,47.4116,2220
1025,3,1.0,1300,1.0,7,1300,0,47.6337,1300
1026,2,1.0,1000,1.0,5,1000,0,47.2841,1350
1027,2,1.5,1556,1.0,7,1556,0,47.3891,2250
1028,3,1.75,1810,1.0,7,1010,800,47.5709,1260
1029,4,2.5,2730,2.0,9,2730,0,47.5414,3090
1030,4,3.75,3070,2.0,9,2400,670,47.633,2940
1031,4,2.0,1620,2.0,7,1620,0,47.395,1710
1032,3,1.0,1200,1.5,7,1200,0,47.3749,1540
1033,2,1.75,2110,1.0,7,2110,0,47.7504,1480
1034,4,1.75,2700,1.5,8,2700,0,47.45399999999999,2220
1035,3,2.0,1540,1.0,7,1540,0,47.5018,1250
1036,2,1.75,1600,1.5,8,1600,0,47.6709,2310
1037,3,2.0,1200,1.0,6,880,320,47.6936,1510
1038,3,2.0,1690,1.5,7,1690,0,47.6801,1690
1039,4,2.5,1910,2.0,7,1910,0,47.3608,2020
1040,3,2.25,1650,2.0,7,1650,0,47.7729,1890
1041,3,2.0,1260,1.0,6,1260,0,47.4401,1300
1042,4,1.75,2130,1.5,8,2130,0,47.6427,1900
1043,3,1.0,1390,1.0,7,1390,0,47.4454,1560
1044,4,2.25,2270,1.0,8,1340,930,47.6528,1800
1045,3,2.0,1740,1.0,8,1740,0,47.4914,2630
1046,3,1.0,1640,1.0,7,1640,0,47.3256,1200
1047,4,2.75,2200,1.0,8,1500,700,47.7713,2120
1048,3,2.25,1620,1.0,7,1280,340,47.5048,1620
1049,5,2.5,3001,2.0,8,3001,0,47.3727,2340
1050,2,1.75,1090,1.0,7,790,300,47.6677,1390
1051,4,2.5,2600,1.5,9,2200,400,47.7076,2840
1052,3,2.5,1910,2.0,8,1910,0,47.5491,1940
1053,3,1.75,1760,1.0,7,1760,0,47.6735,2320
1054,3,1.0,1080,1.0,7,1080,0,47.3215,1230
1055,2,1.0,840,1.0,7,840,0,47.6803,1240
1056,4,1.75,2260,1.0,9,2260,0,47.5498,2880
1057,3,1.0,1800,1.0,7,1020,780,47.5616,1740
1058,4,1.75,1230,1.0,7,1090,140,47.5808,2380
1059,2,1.0,790,1.0,6,790,0,47.6973,1460
1060,4,2.75,3110,2.0,9,3110,0,47.7355,2790
1061,3,2.5,1600,2.0,8,1600,0,47.339,1890
1062,5,3.75,5340,2.5,10,3740,1600,47.5795,3910
1063,3,1.0,1550,1.5,7,1550,0,47.6572,2370
1064,6,3.0,2790,2.5,8,2790,0,47.627,2590
1065,5,2.75,3650,1.0,10,2360,1290,47.6215,3220
1066,5,3.75,3860,2.0,7,3860,0,47.3694,3000
1067,6,1.5,1930,1.0,7,1030,900,47.4869,1780
1068,6,1.5,1930,1.0,7,1030,900,47.4869,1780
1069,3,2.25,2120,1.0,7,1420,700,47.7461,1880
1070,4,2.5,3160,2.0,9,2250,910,47.5672,3460
1071,4,2.25,2770,2.0,8,2770,0,47.6268,2400
1072,2,1.0,880,1.0,7,880,0,47.7436,1960
1073,3,1.75,1420,1.0,7,1420,0,47.6151,2250
1074,3,1.0,1070,1.0,7,1070,0,47.5529,1090
1075,3,2.25,1940,2.0,9,1940,0,47.5636,2580
1076,4,2.5,2520,2.0,9,2520,0,47.7709,2000
1077,4,2.5,3030,2.0,9,3030,0,47.6313,2940
1078,3,2.25,1430,2.0,7,1430,0,47.3116,1600
1079,4,4.5,3780,2.0,11,2770,1010,47.5922,2660
1080,4,2.5,2540,1.0,7,2540,0,47.6317,1560
1081,3,2.25,1570,1.0,7,1070,500,47.6843,2250
1082,4,2.5,2100,1.0,7,1240,860,47.6146,2000
1083,4,3.5,3210,3.0,9,3210,0,47.5203,1360
1084,1,1.0,1090,1.0,6,980,110,47.6999,2160
1085,2,1.0,900,1.0,6,900,0,47.6481,1190
1086,4,2.5,3140,2.0,9,3140,0,47.3826,2650
1087,4,4.25,3010,2.0,10,1940,1070,47.6933,2540
1088,2,1.5,800,2.0,8,800,0,47.6972,1020
1089,2,1.0,1000,1.0,7,1000,0,47.4789,1490
1090,2,1.0,840,1.0,6,840,0,47.4749,1300
1091,3,1.5,1380,1.0,7,1080,300,47.674,1510
1092,3,1.5,1380,1.0,7,1080,300,47.674,1510
1093,2,1.0,1260,1.0,7,1040,220,47.6782,1510
1094,3,2.75,1840,1.0,8,1340,500,47.6802,2060
1095,3,1.5,1840,1.0,8,1220,620,47.5607,2320
1096,3,1.0,970,1.0,5,970,0,47.2808,1050
1097,2,1.0,900,1.0,6,900,0,47.525,900
1098,4,1.5,1770,1.5,7,1240,530,47.5773,1740
1099,4,2.5,2410,1.0,8,1990,420,47.5351,2530
1100,5,2.5,2400,2.0,7,2400,0,47.371,2200
1101,4,2.5,2970,2.0,9,2970,0,47.6717,3100
1102,5,2.0,1700,1.0,7,1000,700,47.549,2000
1103,2,1.0,610,1.0,5,610,0,47.5498,930
1104,4,3.5,3700,2.0,11,3700,0,47.5471,3880
1105,3,1.0,950,1.0,7,950,0,47.572,1060
1106,4,2.5,3860,2.0,8,2930,930,47.5387,3130
1107,4,2.5,3890,2.0,10,3890,0,47.7749,3600
1108,5,1.5,2940,1.0,8,1470,1470,47.7632,1580
1109,3,2.25,2190,1.0,8,2190,0,47.7108,2970
1110,5,2.25,2540,1.5,7,1510,1030,47.6729,1780
1111,3,1.75,1890,1.0,7,1890,0,47.3357,2960
1112,3,3.0,2640,2.0,9,2640,0,47.4759,2680
1113,4,1.75,2410,1.5,8,2410,0,47.6369,1280
1114,3,1.0,1130,1.0,7,1130,0,47.4362,1320
1115,3,1.0,1260,1.0,7,1260,0,47.2979,940
1116,3,2.0,2020,1.5,7,1180,840,47.5496,1400
1117,3,1.75,1820,1.0,7,1230,590,47.7772,1790
1118,4,2.0,1770,2.0,7,1770,0,47.6748,1550
1119,4,1.75,2080,2.0,7,2080,0,47.737,1550
1120,6,3.75,4000,2.0,10,3080,920,47.453,3180
1121,4,3.5,3080,2.0,9,2010,1070,47.5662,1220
1122,3,2.5,2500,2.0,10,2500,0,47.6286,2580
1123,4,2.5,3100,2.0,9,3100,0,47.7151,3100
1124,3,2.5,2080,2.0,9,2080,0,47.6731,2080
1125,4,2.5,2530,1.5,8,1720,810,47.6737,2150
1126,5,4.0,4430,2.0,10,4430,0,47.6168,2470
1127,3,3.25,1490,3.0,8,1220,270,47.6357,1550
1128,3,1.75,1790,1.0,7,1130,660,47.532,1610
1129,3,2.5,1710,3.0,8,1510,200,47.6963,1610
1130,3,2.5,2260,1.5,7,1280,980,47.681,1790
1131,3,2.5,2260,1.5,7,1280,980,47.681,1790
1132,3,1.0,1130,1.0,7,1130,0,47.4743,1440
1133,3,3.75,1950,1.0,8,1360,590,47.505,1950
1134,5,3.0,2140,1.0,7,1280,860,47.5459,1820
1135,4,3.75,3300,1.5,10,2600,700,47.6561,3300
1136,4,2.5,2960,2.0,10,2960,0,47.3646,2770
1137,3,2.0,2390,2.0,7,2390,0,47.6707,1920
1138,3,2.5,2460,2.0,9,2460,0,47.4572,2090
1139,5,2.75,3490,2.0,10,3490,0,47.5825,3480
1140,3,1.0,1700,1.0,6,1700,0,47.4899,1500
1141,3,1.0,1700,1.0,6,1700,0,47.4899,1500
1142,3,2.5,2540,1.0,8,1290,1250,47.7614,2230
1143,3,2.5,2190,1.0,8,1760,430,47.6943,2060
1144,4,2.75,2980,1.0,9,1860,1120,47.6392,2980
1145,4,2.5,2700,1.0,8,1600,1100,47.7258,2290
1146,3,2.0,3200,1.0,8,2000,1200,47.6034,1670
1147,3,1.0,1000,1.0,7,1000,0,47.484,1320
1148,4,2.25,2270,1.0,7,1290,980,47.3261,1930
1149,1,0.75,760,1.0,5,760,0,47.3046,970
1150,2,1.5,1450,1.0,8,1450,0,47.3785,1460
1151,5,2.75,3020,2.0,9,3020,0,47.6806,2250
1152,4,2.5,3290,2.0,9,3290,0,47.598,3450
1153,2,1.5,1090,1.0,8,970,120,47.5798,1700
1154,3,1.75,1360,1.0,8,1360,0,47.547,1350
1155,4,2.0,2610,1.5,6,1690,920,47.4672,1630
1156,5,3.25,3620,2.0,9,3620,0,47.5442,3260
1157,3,1.75,1200,1.0,7,1200,0,47.3864,1564
1158,2,2.75,1992,1.5,6,1288,704,47.3551,1110
1159,4,2.5,2570,1.5,8,1580,990,47.6701,2070
1160,3,1.0,930,1.5,6,930,0,47.5256,1060
1161,2,2.5,1270,3.0,7,1270,0,47.701,1280
1162,3,2.0,2220,1.0,7,1110,1110,47.5807,1450
1163,3,3.5,1540,2.0,7,1360,180,47.542,1220
1164,3,1.5,1530,1.5,7,1530,0,47.3639,2080
1165,3,2.5,2260,1.0,6,2260,0,47.2582,2180
1166,3,2.5,3560,1.0,8,1650,1910,47.6473,2760
1167,4,2.5,2880,2.0,9,2880,0,47.2124,2470
1168,3,1.75,1620,1.0,7,1220,400,47.4815,1470
1169,3,1.5,2050,1.0,7,1350,700,47.5325,1590
1170,5,1.75,2320,1.0,7,1290,1030,47.3426,1740
1171,4,2.5,2440,2.5,8,2440,0,47.6298,2440
1172,4,2.5,1930,2.0,7,1930,0,47.3645,1670
1173,3,1.0,1470,1.0,7,1470,0,47.473,1470
1174,3,1.0,1010,1.0,6,1010,0,47.5249,1520
1175,3,1.0,1010,1.0,6,1010,0,47.5249,1520
1176,2,1.0,770,1.0,4,770,0,47.5325,1420
1177,3,2.5,2620,2.0,8,1830,790,47.6281,2620
1178,4,2.75,3410,1.5,10,3410,0,47.6547,3721
1179,3,2.0,1960,1.0,7,1000,960,47.3972,1660
1180,5,1.5,1750,1.5,7,1750,0,47.7755,1750
1181,3,3.25,2170,1.5,9,1650,520,47.5665,2720
1182,4,2.5,2490,1.0,7,1390,1100,47.4416,2010
1183,4,3.25,3600,2.0,11,3310,290,47.7124,2440
1184,3,1.0,980,1.0,7,980,0,47.7746,1830
1185,4,1.5,1890,1.5,8,1890,0,47.5896,1700
1186,2,1.0,1100,1.5,6,1100,0,47.5275,1280
1187,2,2.0,1370,1.0,8,1370,0,47.70399999999999,1365
1188,6,3.0,2870,2.0,7,2330,540,47.401,2380
1189,3,1.0,1520,1.0,6,1040,480,47.5134,1320
1190,4,2.5,2350,2.0,9,2150,200,47.6344,2240
1191,4,2.0,1370,1.5,7,1370,0,47.4386,1360
1192,6,2.0,1750,1.0,5,1750,0,47.5096,1750
1193,3,2.25,1610,2.0,8,1610,0,47.7,1610
1194,3,2.5,2070,2.0,8,2070,0,47.6036,1530
1195,4,1.75,2410,2.0,8,2060,350,47.6499,2520
1196,4,1.75,2410,2.0,8,2060,350,47.6499,2520
1197,3,1.0,1000,1.0,7,1000,0,47.4829,1490
1198,4,3.5,3150,2.0,9,3150,0,47.5966,3150
1199,4,2.25,2840,1.0,8,2240,600,47.639,2840
1200,4,3.0,2160,1.0,7,1320,840,47.6163,1430
1201,4,1.75,1920,1.0,7,1170,750,47.7041,1480
1202,3,2.75,2850,1.0,8,1540,1310,47.4141,2240
1203,3,1.75,1470,1.0,7,1070,400,47.7394,2630
1204,4,2.25,2460,1.0,8,2460,0,47.3182,1630
1205,3,2.5,1450,2.0,7,1450,0,47.3655,2000
1206,3,2.5,2730,2.0,9,2730,0,47.2831,2710
1207,3,1.0,1140,1.0,6,1140,0,47.4624,1300
1208,4,1.75,2000,1.0,7,1150,850,47.32,2420
1209,3,1.0,900,1.0,5,700,200,47.7146,1750
1210,3,1.75,1770,1.0,7,1400,370,47.7726,2070
1211,3,2.5,2100,2.0,8,2100,0,47.5338,2100
1212,4,2.25,2620,1.0,7,1820,800,47.4662,1728
1213,3,1.75,1060,1.0,7,1060,0,47.7442,1310
1214,2,1.75,1000,1.0,8,1000,0,47.3811,1150
1215,5,2.0,3370,1.5,7,2140,1230,47.6373,1920
1216,3,1.75,1460,1.0,7,1460,0,47.4861,2030
1217,3,1.75,2160,1.0,8,1390,770,47.6777,1290
1218,3,2.5,3190,2.0,9,3190,0,47.6027,3240
1219,2,1.0,980,1.0,7,980,0,47.6903,1520
1220,3,2.0,1360,1.5,6,910,450,47.5587,1440
1221,4,2.0,2240,1.0,8,2240,0,47.6177,2500
1222,2,1.0,1450,1.5,7,1450,0,47.6739,1470
1223,3,3.5,1450,2.0,8,1200,250,47.6475,1490
1224,3,1.5,1820,1.0,7,1200,620,47.4213,1500
1225,5,3.25,5620,2.0,11,4140,1480,47.5786,4470
1226,3,1.75,2080,1.0,7,1040,1040,47.5135,1230
1227,8,6.0,4340,2.0,8,4340,0,47.6316,2050
1228,4,3.25,2860,2.0,9,1980,880,47.6752,2010
1229,3,2.5,2040,2.0,8,2040,0,47.5718,2170
1230,4,1.75,1880,1.0,7,1280,600,47.3272,1980
1231,4,2.0,1560,1.0,7,1560,0,47.7281,1730
1232,2,1.0,1470,1.0,7,1470,0,47.6914,1840
1233,2,1.0,1370,1.0,8,1130,240,47.6473,2460
1234,4,2.75,2640,2.0,9,2640,0,47.5788,2640
1235,3,1.0,1120,1.0,6,1120,0,47.4879,1120
1236,4,1.75,1730,1.0,7,880,850,47.6031,1570
1237,3,2.5,2090,2.0,9,2090,0,47.5651,2860
1238,3,1.5,860,1.0,6,860,0,47.6791,1220
1239,3,2.0,1780,1.0,7,1780,0,47.4617,2140
1240,3,2.5,2180,2.0,8,2180,0,47.7733,2540
1241,3,2.0,1610,1.0,7,1610,0,47.3398,1610
1242,3,1.5,1070,1.0,6,1070,0,47.7633,1480
1243,2,2.0,1540,2.0,7,1540,0,47.551,1540
1244,3,2.0,1340,1.0,7,1340,0,47.3504,1630
1245,3,1.0,920,1.0,6,920,0,47.285,1120
1246,3,2.25,1940,1.0,8,1100,840,47.5018,2180
1247,3,1.75,1590,1.0,8,1590,0,47.5049,1970
1248,2,2.0,1340,1.0,8,1340,0,47.7182,1350
1249,4,2.5,3770,2.0,11,3770,0,47.5646,3710
1250,6,2.5,2680,1.0,7,1340,1340,47.6553,2200
1251,3,1.75,1520,1.0,5,1520,0,47.4924,1240
1252,4,2.5,2410,2.0,9,2410,0,47.7094,2240
1253,4,2.25,1930,2.0,8,1930,0,47.7458,2170
1254,3,1.5,1240,1.0,7,1240,0,47.601000000000006,1260
1255,3,2.5,3110,2.0,9,3110,0,47.5445,4240
1256,3,2.5,1610,2.0,7,1280,330,47.6,1480
1257,4,1.75,1960,1.0,8,1960,0,47.3111,2080
1258,3,1.75,1680,1.0,7,960,720,47.6854,1680
1259,4,3.0,2910,2.0,9,2910,0,47.5223,3040
1260,1,1.0,580,1.0,7,580,0,47.6829,1260
1261,3,1.75,2540,1.0,7,1270,1270,47.7219,1950
1262,2,1.0,810,1.0,7,810,0,47.5425,1490
1263,4,2.5,2650,2.0,7,2650,0,47.7258,2590
1264,3,2.5,2480,2.0,8,2480,0,47.4381,2300
1265,3,1.0,1060,1.0,7,1060,0,47.3801,1620
1266,4,1.75,1640,1.5,7,870,770,47.5334,2460
1267,3,1.0,1230,1.5,6,1230,0,47.5177,1280
1268,4,2.5,1920,2.0,8,1920,0,47.4058,2300
1269,3,2.5,1980,2.0,8,1980,0,47.4492,1700
1270,2,1.0,1200,1.0,6,1200,0,47.4204,1200
1271,4,2.25,2020,1.0,8,1210,810,47.6821,2660
1272,3,2.25,1930,1.0,7,1470,460,47.2624,1510
1273,5,2.5,2710,1.0,8,1720,990,47.6411,3180
1274,5,1.0,1950,1.5,7,1450,500,47.5511,1950
1275,3,1.75,2110,1.0,8,2110,0,47.4742,880
1276,3,1.0,1250,1.0,7,1250,0,47.5517,1404
1277,2,1.0,1010,1.0,7,1010,0,47.6641,1540
1278,3,2.0,1960,1.0,6,980,980,47.5101,2190
1279,4,2.75,2950,2.0,7,1810,1140,47.6525,2000
1280,3,1.5,1340,2.0,7,1040,300,47.698,1220
1281,3,2.5,3240,2.0,7,3240,0,47.5192,2570
1282,3,0.75,490,1.5,5,490,0,47.7112,800
1283,4,2.5,2640,2.0,7,2640,0,47.3505,2640
1284,4,2.5,3220,2.0,9,3220,0,47.6878,3220
1285,4,2.5,3240,1.0,10,2260,980,47.6709,3490
1286,3,1.0,880,1.5,6,880,0,47.7494,1170
1287,3,2.5,3280,2.0,11,3280,0,47.6699,3530
1288,3,2.5,1730,1.0,7,1330,400,47.4099,2100
1289,4,1.75,1710,1.0,7,1710,0,47.5947,1360
1290,2,2.5,1590,2.0,8,1300,290,47.6375,1880
1291,2,1.0,1200,1.0,7,1080,120,47.7001,1200
1292,9,3.0,3680,2.0,7,2830,850,47.6374,1960
1293,6,3.0,2860,1.0,8,1430,1430,47.54600000000001,1920
1294,4,2.75,3190,2.0,9,3190,0,47.5903,3160
1295,3,2.5,1920,2.0,9,1920,0,47.6472,1790
1296,3,0.75,1040,1.0,6,1040,0,47.4518,1270
1297,4,3.25,2880,1.0,11,2270,610,47.6587,1910
1298,3,2.5,2170,2.0,9,2170,0,47.5458,2170
1299,3,1.75,1370,1.0,8,1370,0,47.2969,2100
1300,3,2.0,3190,2.0,9,3190,0,47.2737,2930
1301,5,1.0,1690,1.5,7,1690,0,47.6746,1230
1302,4,3.75,1980,2.0,9,1980,0,47.6901,1480
1303,3,2.0,1900,1.0,7,1340,560,47.305,1690
1304,4,2.5,3050,1.0,8,1550,1500,47.3626,2350
1305,3,2.0,1510,1.0,7,1230,280,47.7053,1950
1306,3,2.5,1910,2.5,8,1530,380,47.6441,1760
1307,3,1.0,1170,2.0,6,1170,0,47.3155,1090
1308,3,1.0,1060,1.0,7,1060,0,47.5649,1060
1309,3,1.0,1250,1.5,6,1250,0,47.2092,1250
1310,5,1.75,2190,1.0,8,1380,810,47.3764,1920
1311,3,1.0,1850,2.0,6,1740,110,47.5446,1520
1312,3,2.0,1520,1.0,7,1520,0,47.4745,1740
1313,3,1.0,1290,1.5,7,1290,0,47.5462,1160
1314,5,1.75,2460,1.0,7,1380,1080,47.7452,2028
1315,3,2.5,1870,1.0,8,1470,400,47.7265,1930
1316,3,2.25,2120,2.0,7,2120,0,47.3364,2420
1317,3,3.5,1450,2.0,8,1160,290,47.6508,1390
1318,2,1.0,1980,1.0,7,1090,890,47.586000000000006,1720
1319,2,1.0,860,1.0,6,860,0,47.7274,1220
1320,3,1.75,1460,1.0,7,1460,0,47.5155,1550
1321,4,2.75,3190,2.0,10,3190,0,47.6991,2750
1322,3,1.75,1960,1.0,7,980,980,47.6975,1480
1323,3,1.5,1360,1.0,7,1360,0,47.4948,1650
1324,3,1.5,1360,1.0,7,1360,0,47.4948,1650
1325,6,3.75,3810,2.0,8,3810,0,47.6938,1610
1326,3,1.75,1340,1.0,7,1100,240,47.3668,1540
1327,3,2.5,1610,2.0,9,1080,530,47.6423,1610
1328,3,2.0,1890,2.0,9,1430,460,47.5438,1780
1329,2,2.0,1070,2.0,9,720,350,47.5213,1070
1330,4,1.75,3050,1.0,8,1800,1250,47.7228,2020
1331,4,3.25,2960,2.0,9,2190,770,47.6526,2150
1332,3,2.5,1750,2.0,8,1750,0,47.6638,1750
1333,4,1.75,2150,1.0,7,2150,0,47.5828,2370
1334,3,1.0,1250,1.0,7,1250,0,47.3414,1450
1335,4,2.0,2080,1.0,7,1330,750,47.5392,2080
1336,4,1.5,1550,1.5,7,1350,200,47.6604,1710
1337,3,2.25,1960,2.0,8,1960,0,47.6642,1860
1338,3,1.0,760,1.0,5,760,0,47.5513,1020
1339,3,1.75,1820,1.0,8,1820,0,47.5068,2490
1340,3,2.25,1640,1.0,8,1320,320,47.6772,1770
1341,3,2.0,2880,1.5,7,2080,800,47.6805,1820
1342,4,3.25,4400,2.0,11,4400,0,47.5927,3240
1343,4,3.0,4280,1.0,11,2180,2100,47.5811,2490
1344,4,2.5,1810,2.0,7,1810,0,47.3531,1760
1345,3,3.0,2490,2.0,10,2490,0,47.5596,2580
1346,4,3.25,3526,2.0,10,3526,0,47.567,3639
1347,2,1.0,1270,1.0,7,1270,0,47.6482,1770
1348,4,1.5,1970,1.5,7,1970,0,47.4612,1880
1349,3,2.5,3020,2.0,7,3020,0,47.3361,2710
1350,3,2.75,2730,1.5,9,1940,790,47.4857,2630
1351,3,2.5,2700,1.0,7,1350,1350,47.397,2470
1352,3,3.0,3700,1.0,10,2170,1530,47.6956,2320
1353,4,1.75,2190,1.0,7,1250,940,47.7396,2190
1354,3,2.5,2630,2.0,8,2630,0,47.688,2330
1355,3,1.5,1090,1.0,7,1090,0,47.4553,1540
1356,2,2.0,1670,1.0,6,860,810,47.5461,1300
1357,2,3.0,2560,1.0,8,2560,0,47.6955,1620
1358,4,2.5,2770,2.0,8,2400,370,47.5536,2120
1359,4,1.5,2040,2.0,9,2040,0,47.6188,3150
1360,2,1.0,960,1.0,7,960,0,47.5314,1760
1361,3,1.0,1910,1.0,7,1010,900,47.697,1600
1362,3,1.0,1320,1.0,7,1320,0,47.7367,1160
1363,2,1.5,1940,1.0,7,970,970,47.6371,1480
1364,4,2.5,2650,2.0,8,2650,0,47.6075,2230
1365,3,2.25,2210,1.0,7,1510,700,47.7574,1870
1366,3,1.75,1540,1.0,6,770,770,47.5305,1140
1367,2,1.0,980,1.0,7,980,0,47.687,1500
1368,4,1.75,1830,1.0,7,930,900,47.6536,1540
1369,3,2.5,2820,2.0,11,2820,0,47.6396,2820
1370,3,1.0,1690,1.0,7,1690,0,47.7099,1080
1371,4,2.5,3280,2.0,7,3280,0,47.6802,2600
1372,4,3.5,3490,2.0,9,3490,0,47.4028,2400
1373,4,2.5,2020,2.0,8,2020,0,47.4318,2820
1374,2,1.75,1310,1.0,6,1310,0,47.5231,1500
1375,5,3.0,4180,2.0,7,4180,0,47.6833,3425
1376,4,2.25,1620,1.0,8,1200,420,47.3394,1620
1377,3,1.0,1290,1.0,7,1290,0,47.5317,1560
1378,4,2.0,1680,1.0,7,840,840,47.6648,1680
1379,3,2.5,2280,2.0,8,2280,0,47.3861,2550
1380,3,2.25,1840,1.5,8,1540,300,47.6063,1800
1381,3,2.0,1930,1.0,8,1260,670,47.7675,1900
1382,3,2.0,1550,1.0,7,1150,400,47.5299,1840
1383,3,2.25,1430,3.0,8,1430,0,47.6916,1430
1384,3,1.5,1670,2.0,8,1670,0,47.6411,2320
1385,4,1.5,1860,1.0,7,1080,780,47.7314,1530
1386,4,3.0,2360,1.0,7,1460,900,47.512,2500
1387,2,1.75,1280,1.0,7,1280,0,47.2631,2180
1388,3,1.0,1240,1.5,6,1240,0,47.4917,1240
1389,4,2.25,2170,1.0,7,1220,950,47.7354,1820
1390,2,1.5,1240,1.0,6,860,380,47.5752,1240
1391,4,2.25,2540,1.0,8,1450,1090,47.719,1780
1392,5,1.75,2020,1.0,7,1220,800,47.51,2220
1393,2,1.0,930,1.0,6,930,0,47.467,1300
1394,4,2.5,2480,2.0,7,2480,0,47.6811,2410
1395,3,1.75,1460,1.0,7,730,730,47.5768,1360
1396,2,1.0,960,1.0,7,960,0,47.5269,1520
1397,3,2.5,1930,1.0,7,1440,490,47.3459,1550
1398,3,1.0,1090,1.5,7,1090,0,47.6846,1520
1399,3,2.5,1850,2.0,7,1850,0,47.3103,1700
1400,6,5.25,3600,2.0,7,2400,1200,47.5656,1450
1401,4,2.0,2470,2.0,7,1970,500,47.4645,1310
1402,3,2.25,1270,2.0,8,1040,230,47.6736,1410
1403,4,2.5,1960,2.0,7,1960,0,47.4849,2420
1404,3,1.75,1900,1.0,7,1390,510,47.7748,2000
1405,3,2.5,1970,1.5,6,1230,740,47.5328,1470
1406,3,2.5,2490,2.0,8,2490,0,47.2119,1850
1407,4,2.5,2680,1.0,8,1380,1300,47.6835,1950
1408,3,1.75,1610,1.0,7,910,700,47.6656,1420
1409,4,2.5,3200,2.0,7,3200,0,47.3666,2840
1410,3,1.75,2140,1.0,7,1570,570,47.4181,2170
1411,3,1.0,1410,1.0,6,1230,180,47.6646,1410
1412,3,1.0,1400,1.0,7,1400,0,47.7508,1950
1413,4,2.5,2260,1.0,8,1770,490,47.5436,2630
1414,4,2.5,3440,1.5,10,2260,1180,47.5636,4230
1415,4,1.75,1400,1.0,7,1050,350,47.7346,2080
1416,3,1.0,1020,1.0,7,1020,0,47.4905,1690
1417,3,2.5,1760,1.5,7,1760,0,47.4612,2160
1418,3,2.5,1860,1.0,7,1860,0,47.4381,1900
1419,1,1.0,500,1.0,5,500,0,47.5252,1350
1420,3,1.0,1470,1.0,7,1020,450,47.3811,2640
1421,6,3.0,3470,1.5,7,3470,0,47.7663,2120
1422,3,1.0,1180,1.0,6,1030,150,47.5726,1280
1423,3,1.0,1250,1.0,7,1250,0,47.6986,1690
1424,4,1.75,2110,1.0,8,1170,940,47.4464,1820
1425,4,2.5,2490,2.0,9,2490,0,47.3305,2690
1426,4,3.25,3450,2.0,10,2430,1020,47.4556,2412
1427,4,2.25,2290,2.0,9,2290,0,47.5878,2290
1428,3,1.0,1030,1.5,7,1030,0,47.574,1440
1429,4,2.25,2240,2.0,7,2240,0,47.687,3180
1430,4,2.5,1780,2.0,8,1780,0,47.5695,1830
1431,5,2.75,2870,1.0,7,1650,1220,47.675,1890
1432,5,4.75,5180,2.0,11,4070,1110,47.5405,3960
1433,4,4.0,4050,2.0,11,3360,690,47.5769,3330
1434,4,1.75,2070,1.0,7,1250,820,47.6045,1650
1435,5,1.0,1860,1.5,7,1530,330,47.6559,1910
1436,2,2.25,1550,2.0,8,1550,0,47.54,1420
1437,3,1.75,1650,1.0,7,1040,610,47.6873,1540
1438,4,3.0,2430,2.0,8,2430,0,47.3533,2430
1439,3,1.0,1060,1.0,8,1060,0,47.5427,1240
1440,4,3.5,3270,2.0,9,2110,1160,47.6256,3020
1441,4,2.25,2050,2.0,8,2050,0,47.5911,2310
1442,3,1.75,1300,1.0,8,1300,0,47.6199,1350
1443,3,2.25,1260,2.0,7,1260,0,47.5454,1630
1444,3,2.25,2780,2.0,8,2780,0,47.67,2890
1445,4,2.75,1920,1.0,8,1010,910,47.5003,1910
1446,4,2.75,2050,1.0,8,1540,510,47.6194,1960
1447,3,1.75,1980,1.0,7,1310,670,47.7353,1450
1448,3,2.5,1690,2.0,8,1150,540,47.5518,1690
1449,4,2.25,2290,2.0,9,2120,170,47.6428,2910
1450,7,3.5,3470,2.0,9,3470,0,47.6203,3040
1451,4,3.0,1540,1.5,7,1540,0,47.6728,1460
1452,3,1.75,1480,1.0,7,1480,0,47.4633,1500
1453,2,1.0,1040,1.0,6,1040,0,47.6981,1880
1454,3,3.25,2960,2.0,10,2960,0,47.7452,2960
1455,4,2.5,2120,2.0,7,2120,0,47.3629,2120
1456,5,2.25,3740,1.5,9,3740,0,47.6234,2180
1457,3,2.5,2480,2.0,9,2480,0,47.684,2480
1458,3,2.0,2290,1.0,7,1490,800,47.6909,1230
1459,4,2.5,2320,1.0,7,1320,1000,47.763000000000005,2160
1460,3,1.0,1640,1.5,7,1640,0,47.6563,2140
1461,4,2.0,1760,1.5,7,1760,0,47.6711,1740
1462,3,2.0,1390,1.0,7,1390,0,47.3786,1530
1463,3,2.75,3230,1.5,8,3230,0,47.7307,2820
1464,3,2.5,1670,2.0,7,1670,0,47.3834,1670
1465,3,2.0,1370,1.0,7,1370,0,47.3867,1620
1466,4,2.25,1910,1.0,8,1300,610,47.6534,1810
1467,4,3.0,4060,1.0,9,2030,2030,47.3059,2950
1468,3,2.0,1350,1.0,7,1350,0,47.3609,1470
1469,3,1.5,1560,1.0,7,1040,520,47.3427,1460
1470,3,2.75,2100,2.0,9,1510,590,47.4347,2240
1471,3,1.5,1370,2.0,7,1370,0,47.7302,1510
1472,2,2.5,1414,2.0,8,1414,0,47.5423,1414
1473,3,1.75,1550,1.0,7,1550,0,47.3098,1760
1474,5,2.5,3597,2.0,7,3597,0,47.3002,3193
1475,3,2.5,1880,2.0,8,1880,0,47.4206,1970
1476,0,1.0,390,1.0,4,390,0,47.526,2170
1477,2,1.75,1350,1.0,8,1350,0,47.7091,1680
1478,4,1.75,2440,1.0,8,1610,830,47.3743,2180
1479,4,2.5,2800,2.0,8,2800,0,47.2675,1970
1480,3,2.5,3780,1.5,10,3780,0,47.7499,3450
1481,4,2.25,2460,1.0,7,1230,1230,47.5285,2090
1482,3,1.5,1190,1.0,7,1190,0,47.7561,1190
1483,3,2.25,2040,2.0,8,2040,0,47.6976,2590
1484,3,2.5,1670,2.0,7,1670,0,47.4424,1610
1485,3,1.75,1840,1.0,8,1840,0,47.5847,2850
1486,5,2.5,2950,2.0,8,2950,0,47.4186,1480
1487,3,1.0,1200,1.0,7,1200,0,47.3261,1230
1488,3,2.5,1360,2.0,7,1360,0,47.6831,1090
1489,3,2.25,2110,1.0,8,1530,580,47.3088,2640
1490,2,1.5,1120,3.0,8,1120,0,47.6524,1370
1491,4,2.25,2360,1.0,8,1640,720,47.75,2320
1492,5,3.0,2540,1.0,8,1270,1270,47.5459,2090
1493,3,1.75,1160,1.0,7,1040,120,47.6926,1530
1494,5,2.25,3120,2.0,9,3120,0,47.6458,3740
1495,5,2.25,3120,2.0,9,3120,0,47.6458,3740
1496,3,2.5,2980,1.5,11,2980,0,47.7133,3670
1497,4,3.25,3830,2.0,9,3830,0,47.6906,4080
1498,4,1.5,1690,1.5,8,1690,0,47.5445,1380
1499,3,2.5,2550,2.0,10,2550,0,47.5996,2030
1500,4,2.25,2710,1.0,7,1850,860,47.3207,1700
1501,4,2.5,2930,2.0,8,2930,0,47.5164,2030
1502,4,2.25,2440,1.0,7,1880,560,47.5933,1530
1503,4,1.75,2280,1.0,7,1280,1000,47.4809,2120
1504,3,1.0,900,1.0,6,790,110,47.4807,1240
1505,2,1.0,980,1.0,6,980,0,47.6744,1270
1506,2,1.0,1270,1.0,7,1100,170,47.6771,1670
1507,5,2.75,1510,2.0,7,1510,0,47.6653,2190
1508,3,1.75,1540,1.0,8,1540,0,47.6207,1990
1509,3,2.5,3380,2.0,8,3380,0,47.6276,1810
1510,3,1.5,1440,1.0,8,1440,0,47.4561,1800
1511,3,1.75,1470,1.0,7,1470,0,47.2026,1430
1512,3,1.0,1660,1.0,7,1270,390,47.5242,1540
1513,4,1.0,1590,1.5,7,1590,0,47.667,2230
1514,4,2.5,2500,1.0,8,1590,910,47.4685,2360
1515,3,1.5,1820,1.0,7,1820,0,47.5886,3020
1516,3,1.75,1670,1.0,8,1670,0,47.549,2290
1517,2,1.0,1030,1.0,8,1030,0,47.5861,1570
1518,3,2.25,3420,1.0,9,1710,1710,47.7412,2290
1519,5,2.5,2200,1.5,7,1420,780,47.6872,1300
1520,3,1.0,1090,1.0,7,1090,0,47.5334,1340
1521,2,1.0,620,1.0,6,620,0,47.6877,1180
1522,4,1.75,1730,2.0,7,1730,0,47.7188,1700
1523,5,2.0,2500,1.0,7,1040,1460,47.7212,2060
1524,3,2.0,1420,1.5,8,1420,0,47.6801,1220
1525,4,2.0,1880,1.0,8,1880,0,47.6872,1610
1526,3,1.0,1300,1.0,7,1300,0,47.282,1420
1527,3,1.75,1680,1.5,8,1680,0,47.5272,1920
1528,4,2.5,2290,2.0,9,2290,0,47.7385,2570
1529,4,3.75,3920,3.0,8,3920,0,47.6805,2040
1530,3,1.75,1720,1.0,7,1140,580,47.6977,1700
1531,4,2.5,2641,2.0,7,2641,0,47.4038,2641
1532,3,1.75,1270,1.0,7,1270,0,47.5362,1220
1533,4,2.25,2410,1.0,8,2410,0,47.5706,2720
1534,3,2.5,1040,3.0,7,1040,0,47.6673,1290
1535,3,1.75,2340,1.5,8,2340,0,47.5432,1970
1536,2,1.0,1110,1.5,6,970,140,47.6453,1884
1537,4,2.5,2790,2.0,9,2790,0,47.6223,2780
1538,4,2.0,1590,1.0,8,1590,0,47.7408,2090
1539,4,2.5,3070,2.0,8,2070,1000,47.659,2560
1540,4,3.5,3270,1.0,8,1660,1610,47.7437,2790
1541,4,2.75,2200,1.0,7,1120,1080,47.74,1210
1542,3,1.75,1850,1.0,8,1850,0,47.7241,1600
1543,3,2.5,2010,2.0,8,1390,620,47.5525,1690
1544,4,2.5,2518,2.0,8,2518,0,47.5894,2280
1545,3,2.5,2600,1.0,9,2600,0,47.6223,2440
1546,3,2.5,2060,1.0,8,1160,900,47.5245,1990
1547,3,2.5,2920,2.0,8,2920,0,47.3809,3150
1548,3,3.0,2290,1.0,8,1420,870,47.3558,1890
1549,3,1.75,2020,1.0,9,2020,0,47.5383,3050
1550,3,2.0,1430,1.0,7,990,440,47.3742,1430
1551,2,2.5,2270,3.0,7,1820,450,47.6757,2180
1552,4,2.5,1910,2.0,8,1910,0,47.3891,1910
1553,2,1.0,960,1.0,6,810,150,47.494,960
1554,2,1.0,1440,1.5,7,1440,0,47.7223,1980
1555,4,2.0,1790,1.0,7,840,950,47.6526,1440
1556,4,1.75,2260,1.0,9,2260,0,47.5976,2430
1557,4,1.75,1760,1.5,7,1760,0,47.5882,3030
1558,5,2.75,2510,1.0,7,1600,910,47.7719,2910
1559,4,2.5,2430,2.0,8,2430,0,47.3779,2890
1560,3,1.75,2430,1.0,8,1630,800,47.4972,2390
1561,2,1.0,1500,1.0,6,1500,0,47.5027,1130
1562,3,1.0,1150,1.0,6,1150,0,47.4613,1230
1563,4,2.75,3660,2.0,10,3660,0,47.6813,3090
1564,5,3.25,3400,2.0,10,3400,0,47.6141,2650
1565,4,1.75,2200,2.0,8,2200,0,47.3131,1910
1566,5,1.75,2140,1.0,7,1200,940,47.6625,1600
1567,4,3.25,4270,2.0,9,3060,1210,47.5362,2850
1568,3,1.75,1340,1.0,7,1340,0,47.4182,1370
1569,1,1.5,1100,1.5,8,1100,0,47.3829,1400
1570,4,2.5,2240,2.0,9,2240,0,47.5276,2410
1571,4,2.5,3140,2.0,8,3140,0,47.4866,3140
1572,4,2.5,3910,2.0,9,2710,1200,47.3766,2650
1573,5,3.0,2220,2.0,7,2220,0,47.543,2340
1574,3,2.5,1440,1.0,8,1440,0,47.5688,1900
1575,3,2.5,2480,2.0,9,2480,0,47.4044,2870
1576,4,2.75,2930,1.0,9,2310,620,47.6264,3810
1577,3,2.25,1570,1.0,8,1180,390,47.6176,1620
1578,4,1.0,1900,1.0,7,1200,700,47.4406,1440
1579,1,2.25,1220,2.0,8,1220,0,47.6703,3150
1580,4,2.5,2810,2.0,8,2810,0,47.3249,1680
1581,3,2.5,2320,2.0,8,2320,0,47.275,2360
1582,3,2.25,1720,2.0,8,1720,0,47.3136,2340
1583,3,2.25,1640,2.0,8,1640,0,47.5689,1780
1584,3,2.25,1400,2.0,9,1400,0,47.695,1500
1585,4,2.75,2300,2.0,9,2300,0,47.6218,2240
1586,3,2.25,2000,1.0,8,1250,750,47.5443,2060
1587,4,2.5,2980,2.0,9,2890,90,47.5445,2980
1588,4,2.0,1850,1.0,7,1850,0,47.5009,1730
1589,4,1.0,1570,1.5,7,1570,0,47.6275,1610
1590,3,2.75,1210,1.5,7,1210,0,47.6798,1630
1591,3,2.75,2200,2.0,8,2200,0,47.6171,2710
1592,3,1.75,2080,1.0,8,2080,0,47.5872,2240
1593,3,1.5,1960,2.0,8,1330,630,47.6423,2090
1594,3,2.25,2070,2.0,8,1490,580,47.5543,1940
1595,2,0.75,760,1.0,4,760,0,47.4703,1100
1596,6,5.0,2850,2.0,7,2850,0,47.6813,1870
1597,3,1.0,1310,1.0,7,960,350,47.2949,1310
1598,4,2.5,2720,2.0,9,2720,0,47.3028,2570
1599,3,2.0,1170,1.0,7,1170,0,47.3333,1410
1600,3,1.75,1390,1.0,8,1390,0,47.2015,1770
1601,4,1.5,1540,2.0,7,1540,0,47.3317,1580
1602,4,2.25,1770,2.0,7,1770,0,47.4192,1770
1603,5,3.75,3830,2.0,10,3830,0,47.5837,3570
1604,3,1.0,1520,1.0,6,1520,0,47.7699,1500
1605,2,1.0,660,1.0,5,660,0,47.4938,970
1606,3,1.0,1800,1.0,7,1200,600,47.525,1450
1607,5,1.5,3050,1.5,8,1920,1130,47.621,1200
1608,3,2.5,3610,1.0,8,1950,1660,47.6306,2620
1609,3,1.75,1660,1.0,7,1660,0,47.6503,2090
1610,3,1.75,1180,1.0,6,760,420,47.6825,1490
1611,4,2.5,2650,2.0,8,2650,0,47.3693,2510
1612,3,2.25,1750,1.0,8,1270,480,47.7739,2170
1613,2,1.0,770,1.0,6,770,0,47.766000000000005,990
1614,5,2.0,2130,1.0,7,1440,690,47.7403,2310
1615,3,1.0,1050,1.0,7,1050,0,47.4038,1340
1616,3,1.0,1040,1.5,7,1040,0,47.6754,1440
1617,3,1.0,840,1.0,6,840,0,47.3685,870
1618,4,2.5,3880,2.0,10,3880,0,47.5841,3280
1619,3,1.0,1570,1.0,7,1070,500,47.6942,1770
1620,4,2.5,2450,2.0,9,2450,0,47.6323,2730
1621,3,1.75,1440,1.0,7,1440,0,47.7296,1460
1622,3,1.5,1050,1.0,6,800,250,47.6578,1530
1623,5,2.75,2530,1.0,7,1520,1010,47.4683,2400
1624,2,1.0,960,1.0,6,960,0,47.4698,1260
1625,4,1.75,1710,1.0,8,1710,0,47.7721,1940
1626,4,2.5,3400,2.0,11,3400,0,47.7168,2880
1627,3,1.5,1260,1.0,7,780,480,47.6693,1540
1628,3,2.25,1940,1.0,7,1240,700,47.6004,2340
1629,4,2.25,2820,1.0,8,1920,900,47.3186,2320
1630,2,1.0,720,1.0,5,720,0,47.303,940
1631,4,2.5,2038,2.0,8,2038,0,47.3296,2634
1632,3,2.25,1720,1.0,7,1220,500,47.2979,1690
1633,4,2.0,1690,1.0,7,1210,480,47.6052,1620
1634,4,2.5,1620,2.0,7,1620,0,47.5132,1590
1635,4,2.5,2360,2.0,9,2360,0,47.774,2750
1636,3,1.75,1800,2.0,8,1800,0,47.7762,2100
1637,5,3.0,2980,1.0,7,1680,1300,47.7372,1590
1638,5,3.0,2980,1.0,7,1680,1300,47.7372,1590
1639,3,1.75,1790,1.0,7,1790,0,47.732,3270
1640,3,2.5,1690,2.0,8,1150,540,47.5518,1690
1641,3,1.0,1320,1.5,7,1320,0,47.5288,1010
1642,3,1.0,1060,1.0,7,1060,0,47.201,1300
1643,1,2.25,1940,2.0,7,1100,840,47.7313,1580
1644,2,1.0,1620,1.0,6,850,770,47.7119,2460
1645,3,1.5,1360,1.0,7,1360,0,47.3799,1890
1646,6,2.5,3610,2.0,8,3210,400,47.7692,2210
1647,3,2.5,2170,2.0,9,2170,0,47.5453,2170
1648,2,1.5,1330,1.0,7,900,430,47.6359,1610
1649,3,2.75,3580,2.0,10,2210,1370,47.3244,3990
1650,4,1.75,1930,1.5,8,1670,260,47.7078,2730
1651,4,1.75,1310,1.0,7,1310,0,47.7559,2280
1652,2,2.25,1910,1.0,7,1010,900,47.4206,2050
1653,3,1.0,1010,1.0,7,1010,0,47.735,1110
1654,4,1.75,2450,1.0,9,1630,820,47.5564,3150
1655,4,2.5,1820,2.0,7,1820,0,47.735,1820
1656,3,2.0,1090,1.0,7,940,150,47.5118,1840
1657,4,4.5,4060,2.0,10,4060,0,47.4241,1830
1658,4,2.0,1470,1.0,8,1470,0,47.3742,1640
1659,4,2.5,3270,2.0,9,3270,0,47.5373,3120
1660,2,1.0,1790,1.0,8,1360,430,47.691,1790
1661,3,2.5,2830,2.0,9,2830,0,47.7462,2710
1662,4,2.5,3150,2.0,9,3150,0,47.7082,3150
1663,5,3.25,3930,2.0,9,2910,1020,47.6802,2040
1664,6,2.75,2840,1.0,8,1420,1420,47.5518,2250
1665,5,3.25,3930,2.0,10,2540,1390,47.5631,3600
1666,3,1.0,990,1.0,7,990,0,47.4151,1420
1667,4,1.75,1560,2.0,7,1560,0,47.5292,1250
1668,2,1.75,2120,1.0,6,1440,680,47.6974,1590
1669,3,1.0,1460,1.0,5,1260,200,47.4958,1150
1670,3,1.0,1580,1.0,7,1580,0,47.4964,1180
1671,3,2.25,2060,1.0,8,2060,0,47.6534,2030
1672,4,1.75,1820,1.0,7,1080,740,47.4104,1810
1673,3,1.75,2220,1.5,7,2220,0,47.4693,2010
1674,5,3.0,2480,1.0,7,1300,1180,47.4964,2290
1675,3,1.0,1260,1.0,6,1260,0,47.7476,1990
1676,3,2.0,1680,1.0,6,880,800,47.3924,2150
1677,5,2.5,2260,2.0,8,2260,0,47.352,2180
1678,3,1.75,1700,1.0,7,1700,0,47.6276,2100
1679,4,2.0,1810,1.0,7,1110,700,47.4307,1810
1680,4,2.75,2210,2.0,8,1730,480,47.3541,1750
1681,4,2.5,2700,2.0,9,2700,0,47.4356,2900
1682,4,1.0,1680,1.5,6,1680,0,47.5354,1560
1683,2,1.0,1390,1.0,6,910,480,47.4646,1610
1684,4,2.25,2240,2.0,8,2240,0,47.728,2240
1685,3,2.25,1790,2.0,8,1790,0,47.5541,2060
1686,4,2.0,1870,1.0,7,1200,670,47.5309,1270
1687,3,1.0,1300,1.0,7,1300,0,47.5063,1740
1688,4,3.0,3280,1.5,7,3280,0,47.7509,3210
1689,4,1.75,1800,1.0,6,900,900,47.7744,1770
1690,3,1.75,1660,1.0,7,960,700,47.5734,1510
1691,3,1.75,1770,1.0,7,1020,750,47.5862,2000
1692,3,2.0,1540,1.0,7,1120,420,47.7605,1910
1693,4,2.0,2000,1.5,7,2000,0,47.5787,2200
1694,4,2.75,2810,1.0,8,1640,1170,47.6745,2400
1695,3,2.25,1750,1.0,7,1210,540,47.7305,1930
1696,4,2.75,2430,1.0,7,2430,0,47.775,2580
1697,4,2.75,2660,1.5,8,1590,1070,47.3078,2250
1698,3,2.0,1380,1.0,7,1380,0,47.5951,1380
1699,4,3.75,4160,2.0,11,4160,0,47.669,5330
1700,3,2.5,1940,1.0,7,1460,480,47.3491,1750
1701,3,2.0,2200,1.0,8,1200,1000,47.7584,2600
1702,2,1.0,1095,1.5,7,1095,0,47.6058,1310
1703,2,1.0,850,1.0,6,750,100,47.5282,1880
1704,1,1.0,690,1.0,5,690,0,47.3109,1330
1705,3,1.0,1400,1.0,7,1400,0,47.2738,1440
1706,3,1.75,2350,1.0,7,1180,1170,47.3594,1680
1707,3,1.75,1950,1.0,7,1950,0,47.7282,2340
1708,3,1.5,1540,1.0,7,1540,0,47.4755,1550
1709,2,2.0,1440,1.0,7,1440,0,47.7648,1780
1710,2,1.0,820,1.0,5,820,0,47.7076,1810
1711,2,1.0,820,1.0,5,820,0,47.7076,1810
1712,3,2.5,2010,2.0,8,2010,0,47.732,2010
1713,4,2.5,2540,2.0,9,2540,0,47.7034,3640
1714,4,3.0,2130,1.5,7,2130,0,47.4871,1070
1715,3,1.0,1130,1.0,7,1130,0,47.4852,1390
1716,3,2.0,1690,1.0,7,1690,0,47.2132,1850
1717,5,3.25,3410,2.0,9,2760,650,47.6285,3540
1718,4,2.75,2860,1.0,7,1560,1300,47.6723,2290
1719,3,2.0,1550,1.5,8,1550,0,47.5222,1440
1720,3,2.75,1320,1.0,7,880,440,47.365,1490
1721,3,1.75,1390,1.0,7,1390,0,47.4892,1910
1722,2,0.75,1392,1.5,7,1392,0,47.4491,1640
1723,4,2.75,2750,1.0,9,1720,1030,47.3566,2860
1724,3,2.25,2220,1.0,8,1280,940,47.6212,2020
1725,3,1.75,2390,1.0,7,1290,1100,47.7759,2270
1726,5,2.0,1870,1.5,7,1870,0,47.5951,1870
1727,2,1.5,940,1.0,7,810,130,47.5375,940
1728,4,2.0,2300,1.0,6,1150,1150,47.3282,1230
1729,4,1.75,2600,1.5,8,2600,0,47.6634,2750
1730,4,2.25,2290,1.0,8,1780,510,47.5617,2360
1731,2,2.5,1470,2.0,8,1470,0,47.6874,1470
1732,3,2.5,2850,1.5,10,1790,1060,47.5894,2850
1733,4,2.25,1600,1.0,7,1080,520,47.4629,1620
1734,4,2.5,2090,2.0,8,2090,0,47.4289,2080
1735,5,3.25,4020,2.0,9,3120,900,47.6349,3550
1736,4,2.5,3030,1.0,9,2380,650,47.6367,1940
1737,3,2.0,1210,1.0,7,1210,0,47.5731,1690
1738,3,1.0,920,1.0,7,920,0,47.3791,1660
1739,2,1.0,700,1.0,6,700,0,47.7712,1250
1740,4,1.5,2100,1.5,8,2100,0,47.6497,1930
1741,3,1.0,1540,1.5,7,1540,0,47.7213,1540
1742,3,2.0,1420,1.0,7,1420,0,47.3287,1550
1743,4,1.75,1450,1.0,7,1450,0,47.4546,1340
1744,2,2.0,1660,1.0,8,1660,0,47.7094,1670
1745,4,3.25,3990,2.0,9,3990,0,47.6784,3920
1746,5,4.75,6390,2.0,10,4560,1830,47.6312,4010
1747,3,2.0,1590,1.0,7,1590,0,47.7239,1320
1748,4,3.25,3500,2.0,10,3500,0,47.5902,3500
1749,3,3.0,2110,1.0,7,1110,1000,47.5696,1730
1750,4,3.5,4570,2.0,11,4570,0,47.5859,4700
1751,3,3.0,3760,1.0,10,2640,1120,47.308,2820
1752,5,3.5,3530,2.0,7,2380,1150,47.7309,2110
1753,4,1.0,1470,1.5,7,1470,0,47.4819,1230
1754,4,1.75,2220,1.0,8,1280,940,47.7065,2210
1755,2,1.0,1120,1.0,6,1120,0,47.763000000000005,1340
1756,2,1.0,1270,1.5,7,1270,0,47.5949,1980
1757,4,2.5,3830,1.0,11,2370,1460,47.7404,3080
1758,5,3.5,4350,2.0,10,3520,830,47.5396,3260
1759,1,1.0,1370,1.5,7,1370,0,47.5571,1450
1760,4,2.5,2740,2.0,9,2740,0,47.5672,2630
1761,4,3.0,3150,2.0,9,3150,0,47.5959,3150
1762,4,2.5,3280,2.0,11,3280,0,47.6398,3280
1763,5,2.0,2900,2.0,7,2900,0,47.74100000000001,1260
1764,3,1.0,1340,1.5,5,1340,0,47.477,1240
1765,4,2.0,1600,1.0,7,1600,0,47.2015,1540
1766,3,2.0,2570,1.0,7,2570,0,47.5547,2010
1767,5,3.0,2640,2.0,7,2140,500,47.6188,1540
1768,2,1.75,1210,2.0,8,1210,0,47.5522,1210
1769,3,2.0,1840,1.0,7,1010,830,47.6862,1760
1770,4,1.75,1650,1.0,8,1650,0,47.4507,1750
1771,3,2.5,3370,2.0,9,3370,0,47.5855,2980
1772,3,1.75,1490,1.0,7,1210,280,47.6208,2090
1773,3,1.0,1180,1.0,7,1180,0,47.7276,1450
1774,4,2.25,1880,2.0,7,1880,0,47.3214,1580
1775,3,1.75,1320,1.0,7,1320,0,47.7229,1370
1776,3,2.0,1150,1.5,7,1150,0,47.6985,1230
1777,4,2.25,2120,2.0,7,1420,700,47.6893,1420
1778,3,1.75,1890,1.0,7,1290,600,47.6831,1320
1779,2,1.0,1130,1.0,6,1130,0,47.4997,1060
1780,2,1.0,1120,1.0,7,1120,0,47.619,3040
1781,4,3.25,4060,2.0,11,4060,0,47.581,3220
1782,4,2.75,4430,2.0,10,4430,0,47.6392,3820
1783,3,2.5,3420,1.0,10,1750,1670,47.5706,2900
1784,4,2.25,2010,1.0,7,1220,790,47.7328,1820
1785,5,2.5,2750,1.5,8,1750,1000,47.6729,1520
1786,3,2.5,2050,2.0,9,2050,0,47.5279,2410
1787,4,2.75,2720,2.0,8,1790,930,47.6624,1360
1788,3,2.5,2490,2.0,9,2490,0,47.5355,2500
1789,4,2.0,1510,1.0,7,1510,0,47.54600000000001,1510
1790,4,4.25,4720,3.0,11,4720,0,47.7591,3010
1791,3,2.0,1300,1.0,7,1300,0,47.5482,1230
1792,2,1.0,700,1.0,5,700,0,47.4953,960
1793,3,1.0,800,1.0,6,800,0,47.6546,1480
1794,3,1.0,1140,2.0,7,1140,0,47.6012,1510
1795,4,2.5,2060,1.0,8,1320,740,47.5549,2050
1796,3,1.75,2100,1.0,7,1340,760,47.5743,1640
1797,3,1.0,880,1.0,6,880,0,47.4995,1130
1798,5,5.0,5450,2.0,11,5450,0,47.6209,3160
1799,2,1.5,1290,1.0,8,660,630,47.6118,1860
1800,4,2.25,2860,2.0,10,2860,0,47.6451,2890
1801,4,2.5,2660,1.0,8,1880,780,47.43899999999999,1910
1802,3,2.5,2110,2.0,8,2110,0,47.3878,2110
1803,3,2.0,1200,1.0,7,600,600,47.5811,1730
1804,4,2.25,2360,2.0,8,1520,840,47.6771,1810
1805,3,1.75,1900,1.0,8,1900,0,47.7455,1710
1806,3,1.0,1250,1.0,7,1250,0,47.5065,1040
1807,2,1.5,870,1.0,7,870,0,47.6509,2090
1808,4,3.25,3570,2.0,10,3570,0,47.536,4100
1809,4,3.25,3780,2.0,11,3780,0,47.521,3720
1810,4,1.5,1520,1.0,7,1520,0,47.3136,1370
1811,4,2.5,1840,2.0,8,1840,0,47.4683,1840
1812,2,1.0,860,1.0,6,860,0,47.5081,1100
1813,3,1.0,1330,2.0,6,1330,0,47.43600000000001,1490
1814,2,1.0,1360,1.0,5,1360,0,47.5229,1460
1815,2,1.0,1120,1.0,7,1120,0,47.5663,1120
1816,2,2.0,1550,1.5,7,1550,0,47.654,1180
1817,3,2.25,3330,2.0,10,3330,0,47.7262,3360
1818,4,3.5,3840,2.0,11,3840,0,47.615,2430
1819,3,2.25,4470,2.0,9,3240,1230,47.574,2930
1820,3,1.0,1780,1.0,7,1060,720,47.4932,1450
1821,4,2.5,1850,2.0,8,1850,0,47.735,2080
1822,3,2.25,2200,2.0,8,2200,0,47.3727,2060
1823,2,1.0,1090,1.0,7,1090,0,47.696000000000005,1090
1824,3,1.0,1010,1.0,7,1010,0,47.4518,1260
1825,4,2.5,2050,2.0,8,2050,0,47.196000000000005,1970
1826,4,2.5,3190,2.0,9,3190,0,47.5317,2630
1827,4,2.5,1870,1.0,7,1100,770,47.4521,1590
1828,4,2.5,2200,2.0,8,2200,0,47.3406,2310
1829,3,4.0,4160,2.0,11,4160,0,47.6635,4300
1830,4,2.5,1780,2.0,9,1780,0,47.3774,2650
1831,3,2.25,2200,2.0,8,2200,0,47.7266,2290
1832,2,1.0,800,1.0,6,800,0,47.7621,1220
1833,3,1.0,990,1.0,6,990,0,47.6228,1100
1834,3,1.75,1260,1.0,7,1110,150,47.5417,1540
1835,4,2.5,2150,2.0,8,2150,0,47.4053,1910
1836,3,2.25,2880,2.0,8,1920,960,47.5878,2880
1837,3,2.0,3000,1.0,8,1500,1500,47.7058,2400
1838,4,2.5,1820,2.0,7,1820,0,47.7346,1820
1839,4,2.5,2300,1.0,7,1840,460,47.4044,2120
1840,4,3.5,2490,2.0,8,2490,0,47.4161,1960
1841,3,1.75,1560,1.0,6,780,780,47.6515,1470
1842,2,1.0,1140,1.0,6,1140,0,47.5187,1110
1843,5,3.5,3150,1.0,9,1620,1530,47.7469,3150
1844,5,2.75,3110,2.0,9,3110,0,47.543,3550
1845,4,1.5,1850,2.0,8,1660,190,47.6376,1970
1846,2,1.0,750,1.0,6,750,0,47.5198,1020
1847,3,2.5,1870,2.0,8,1870,0,47.5493,1940
1848,3,1.0,1490,1.0,7,1490,0,47.7276,1280
1849,4,2.0,1700,1.0,7,850,850,47.5774,1620
1850,2,2.0,1450,3.0,9,1450,0,47.6354,1490
1851,5,1.75,1260,1.5,7,1260,0,47.6452,1410
1852,2,2.0,1260,1.0,7,1020,240,47.2593,1560
1853,4,1.75,2100,2.0,8,2100,0,47.567,1630
1854,4,2.5,2430,2.0,8,2430,0,47.3352,2100
1855,4,3.25,4250,2.0,10,3350,900,47.5612,3790
1856,2,1.0,1310,1.0,6,1310,0,47.6854,1550
1857,2,1.0,1460,1.0,7,1260,200,47.7009,1580
1858,3,1.0,820,1.5,6,820,0,47.528,1470
1859,3,2.5,2790,2.0,8,2790,0,47.5958,2620
1860,3,1.0,950,1.0,7,950,0,47.5746,1260
1861,2,1.0,870,1.0,7,870,0,47.4493,1070
1862,3,1.0,1000,1.0,7,1000,0,47.4825,1420
1863,4,2.5,2740,1.0,8,1980,760,47.7648,2170
1864,5,2.25,2500,1.5,7,2500,0,47.7379,1980
1865,4,2.5,3280,2.0,7,3280,0,47.6798,2600
1866,2,1.0,670,1.0,5,670,0,47.5769,700
1867,4,2.5,1920,2.0,7,1920,0,47.3795,2200
1868,3,1.75,2000,1.0,7,1140,860,47.3752,1060
1869,6,4.0,3600,2.0,9,2610,990,47.6531,1430
1870,4,2.5,2740,2.0,9,2740,0,47.3535,3010
1871,9,4.5,3650,2.0,8,2530,1120,47.6604,2510
1872,3,1.75,1540,1.0,7,1540,0,47.7663,3790
1873,3,2.5,1950,2.0,9,1950,0,47.7217,2650
1874,4,1.75,1500,1.0,7,1000,500,47.2918,1700
1875,3,2.5,3370,1.0,10,3370,0,47.4379,3350
1876,3,2.5,3830,2.0,11,3830,0,47.5663,2950
1877,3,2.25,2100,2.0,7,2100,0,47.595,1650
1878,3,1.5,2240,1.0,7,2240,0,47.6762,2150
1879,4,2.25,2350,1.0,9,2350,0,47.3533,2580
1880,4,2.5,1940,2.0,8,1940,0,47.2632,2400
1881,3,1.5,1840,2.0,8,1840,0,47.7145,2100
1882,4,1.75,2260,1.0,8,1620,640,47.6224,1960
1883,5,2.75,2740,1.0,8,1370,1370,47.5563,2020
1884,2,2.5,1090,2.0,7,1090,0,47.5347,1410
1885,3,2.25,1820,1.0,7,1820,0,47.331,1520
1886,4,2.0,1370,1.0,7,1370,0,47.749,1280
1887,4,2.25,2370,1.0,8,1550,820,47.7684,1890
1888,5,3.0,2790,1.0,7,1500,1290,47.4088,1620
1889,3,2.5,1570,2.0,7,1570,0,47.7364,1740
1890,3,1.0,1020,1.5,7,1020,0,47.5254,1240
1891,2,1.0,1300,1.0,7,1300,0,47.7281,1600
1892,3,1.0,1270,1.0,7,1270,0,47.5874,1470
1893,3,1.75,1490,1.0,6,990,500,47.4917,1490
1894,4,1.75,2190,1.0,8,2020,170,47.4979,1920
1895,3,1.75,2200,1.0,7,1240,960,47.4119,1770
1896,4,1.0,1740,1.5,7,1740,0,47.6058,1590
1897,3,1.5,1410,1.0,7,1410,0,47.6402,1370
1898,3,2.0,1840,1.0,7,1840,0,47.6916,2300
1899,4,2.5,2570,2.0,9,2570,0,47.6373,2760
1900,4,3.5,3010,2.0,9,3010,0,47.5533,2520
1901,3,1.75,1810,1.0,7,1240,570,47.4674,1850
1902,3,2.0,1460,1.0,7,940,520,47.682,1460
1903,5,2.75,3360,2.0,9,3360,0,47.7754,3360
1904,4,2.25,2740,1.0,10,1980,760,47.7117,2790
1905,3,2.0,1680,2.0,7,1180,500,47.5536,1400
1906,4,2.5,2070,2.0,7,2070,0,47.531000000000006,2340
1907,3,1.75,1620,1.0,7,1620,0,47.4749,1660
1908,4,1.0,1500,1.5,6,1500,0,47.4768,1330
1909,3,2.5,3380,2.0,8,2200,1180,47.7462,2060
1910,3,2.25,1700,1.5,7,1100,600,47.6784,1700
1911,3,1.0,1580,1.0,7,1180,400,47.6505,1560
1912,2,2.5,1740,2.0,8,1210,530,47.622,1640
1913,3,2.5,1840,1.0,7,1290,550,47.7586,2160
1914,3,1.75,1255,3.0,8,1255,0,47.6958,1010
1915,3,1.75,1840,1.0,7,1240,600,47.3933,1980
1916,4,2.5,2960,2.0,9,2960,0,47.3596,2570
1917,5,4.75,5990,2.0,11,4050,1940,47.5554,3330
1918,5,2.5,2130,2.0,7,2130,0,47.4726,1500
1919,3,2.5,2380,2.0,8,2380,0,47.5372,2580
1920,3,2.25,1780,2.0,8,1780,0,47.4575,2440
1921,3,1.5,1220,1.0,7,1220,0,47.5467,2110
1922,4,2.0,1440,2.0,7,1440,0,47.5717,1300
1923,3,2.5,2620,2.0,8,2620,0,47.3675,2190
1924,5,3.25,3320,2.0,8,2480,840,47.3904,2330
1925,5,2.5,2040,1.0,7,1240,800,47.6544,1800
1926,4,2.5,2930,2.0,8,2930,0,47.7199,2120
1927,5,1.75,2290,2.0,7,1980,310,47.664,2870
1928,3,1.0,1280,1.0,6,1280,0,47.4491,1170
1929,3,2.25,1660,2.0,7,1660,0,47.7362,1680
1930,4,2.25,2240,1.0,8,1740,500,47.6323,1890
1931,4,2.75,2730,1.5,8,1550,1180,47.6737,1860
1932,6,3.0,2890,2.5,7,2290,600,47.6227,2180
1933,4,1.75,2440,1.0,9,2040,400,47.6339,2040
1934,3,2.5,1720,1.0,8,1000,720,47.6631,1720
1935,5,2.0,2400,1.0,7,1210,1190,47.5112,1760
1936,3,2.25,1610,1.0,7,1110,500,47.3683,1690
1937,4,3.0,2330,2.0,9,1920,410,47.554,2330
1938,4,2.5,2020,1.5,6,2020,0,47.5223,1440
1939,3,2.5,1680,3.0,9,1680,0,47.6604,1950
1940,3,2.5,2000,2.0,7,2000,0,47.4733,2000
1941,3,3.25,3330,2.5,9,3330,0,47.5395,4340
1942,3,1.75,1510,1.0,7,1510,0,47.5069,1480
1943,4,3.0,3110,2.0,8,3110,0,47.3279,2820
1944,4,2.5,2150,2.0,8,2150,0,47.6962,2030
1945,4,2.5,1990,2.0,8,1990,0,47.7678,2220
1946,3,1.75,1880,1.0,7,1880,0,47.5089,1900
1947,3,1.5,1890,1.0,7,1090,800,47.5396,1750
1948,3,2.25,1820,1.0,7,1120,700,47.5684,1970
1949,4,3.5,4370,2.0,10,3610,760,47.5876,2960
1950,3,2.5,1600,2.0,7,1600,0,47.4899,1600
1951,4,1.0,1360,1.5,7,1360,0,47.6878,1530
1952,3,2.5,1970,2.0,7,1970,0,47.3627,1980
1953,3,2.0,1470,2.0,8,1310,160,47.5653,1470
1954,2,1.0,810,1.0,7,810,0,47.7289,1080
1955,4,2.5,1830,1.0,8,1540,290,47.7741,1990
1956,3,2.5,1540,2.0,7,1300,240,47.586000000000006,1540
1957,3,1.0,940,1.0,6,940,0,47.6744,1500
1958,2,1.75,1440,1.0,8,1440,0,47.7143,1680
1959,4,2.25,2300,1.5,7,1340,960,47.5895,1540
1960,4,2.5,4940,1.0,9,3450,1490,47.5095,2430
1961,2,2.0,1980,1.5,7,1220,760,47.6809,1280
1962,3,1.0,840,1.0,6,840,0,47.3704,870
1963,4,2.75,3120,1.0,9,1980,1140,47.5389,3330
1964,3,1.75,710,1.0,6,710,0,47.5194,900
1965,3,1.75,2290,1.0,8,1620,670,47.7735,2320
1966,5,2.5,3750,2.0,10,3750,0,47.5379,3540
1967,3,1.0,1460,1.0,6,880,580,47.7009,1530
1968,5,3.75,3500,1.5,8,3500,0,47.6745,3250
1969,3,2.25,1790,1.0,7,1390,400,47.7321,1940
1970,4,2.5,2780,2.0,8,2780,0,47.5989,2510
1971,3,1.75,1370,1.0,7,1370,0,47.3815,1400
1972,5,1.75,2230,1.0,7,1230,1000,47.5055,1380
1973,3,1.5,1790,1.5,8,1790,0,47.6332,1780
1974,3,1.0,1150,1.5,7,1150,0,47.7435,1600
1975,3,2.25,1580,1.0,7,1180,400,47.3564,1470
1976,3,2.5,2750,2.0,9,2750,0,47.75,2780
1977,3,1.75,1120,1.0,7,870,250,47.6684,1470
1978,3,1.0,1560,1.5,7,1560,0,47.5936,1280
1979,2,1.0,1100,1.0,7,1100,0,47.5312,1240
1980,3,3.25,2620,1.0,8,1770,850,47.5836,2180
1981,4,1.5,1490,2.0,7,1490,0,47.3684,1490
1982,4,2.5,3440,2.0,9,3440,0,47.6969,3150
1983,4,1.75,2000,1.0,7,1000,1000,47.5925,1690
1984,3,1.75,1680,1.0,8,1150,530,47.5199,2100
1985,3,2.5,3680,1.5,9,3680,0,47.6903,2410
1986,3,3.25,3780,1.0,11,2650,1130,47.5506,3850
1987,4,2.5,2360,1.0,7,1460,900,47.7201,1590
1988,4,1.75,2090,1.0,7,1090,1000,47.6802,1760
1989,3,1.5,1560,1.0,7,1220,340,47.6729,1870
1990,2,1.0,730,1.0,4,730,0,47.35,1220
1991,4,2.75,2910,1.0,8,1640,1270,47.7352,1970
1992,3,2.75,2930,2.0,8,2930,0,47.5481,2450
1993,3,2.25,1700,1.0,7,1200,500,47.3601,1700
1994,2,1.0,720,1.0,6,720,0,47.6604,1460
1995,3,2.25,1570,1.0,7,1180,390,47.3568,1570
1996,3,2.25,1500,1.0,7,1150,350,47.3146,1540
1997,3,2.5,1300,1.5,7,1300,0,47.6838,1400
1998,3,2.0,2510,1.0,9,2510,0,47.4012,3140
1999,3,2.5,2920,1.0,9,1800,1120,47.5799,2480
2000,3,2.5,2110,2.0,9,2110,0,47.5269,2390
2001,3,1.0,1175,1.0,6,1175,0,47.6388,2010
2002,2,1.0,1070,1.0,7,1070,0,47.7532,1500
2003,3,1.75,1160,1.0,7,1160,0,47.3643,1470
2004,4,2.5,3580,2.0,9,3580,0,47.3901,2510
2005,2,2.0,1900,1.0,7,1150,750,47.5227,1140
2006,5,2.25,2000,1.0,7,1300,700,47.4291,2000
2007,3,2.0,1400,1.0,7,1150,250,47.4655,1820
2008,3,2.0,1400,1.0,7,1150,250,47.4655,1820
2009,3,2.5,1990,2.0,8,1990,0,47.5911,2250
2010,4,2.5,2390,2.0,8,2390,0,47.7433,1960
2011,3,2.5,2030,2.0,8,2030,0,47.7251,1960
2012,3,2.0,1430,1.0,7,1430,0,47.2757,1870
2013,2,1.0,940,1.0,5,940,0,47.5065,1290
2014,3,2.5,1920,2.0,8,1920,0,47.7144,1380
2015,4,2.5,2900,2.0,11,2900,0,47.6696,3390
2016,3,2.5,1660,2.0,7,1660,0,47.5434,1540
2017,2,2.5,2170,1.0,8,2170,0,47.7242,2170
2018,4,2.5,2240,1.0,8,1380,860,47.5011,1540
2019,4,1.75,1740,1.0,7,1740,0,47.6259,1740
2020,5,3.0,3040,2.0,9,3040,0,47.548,1650
2021,3,2.5,2370,2.0,8,2370,0,47.354,2380
2022,3,2.25,1470,2.0,8,1090,380,47.5388,1470
2023,3,2.0,1460,1.0,7,1460,0,47.6233,1850
2024,3,1.75,1530,1.0,7,1150,380,47.6872,1610
2025,4,3.5,4740,2.0,11,3640,1100,47.5375,4042
2026,3,1.5,1710,2.0,8,1710,0,47.5714,1910
2027,4,2.5,2840,1.0,8,1420,1420,47.5542,2310
2028,3,2.0,1860,1.0,7,1320,540,47.7165,1830
2029,3,2.5,2250,2.0,8,2250,0,47.4865,2020
2030,3,1.75,2120,1.0,7,1060,1060,47.7083,1840
2031,4,2.25,2260,1.0,9,2260,0,47.6622,2650
2032,3,1.5,1060,1.0,7,1060,0,47.5512,1060
2033,4,3.25,3530,2.0,11,3530,0,47.7193,3850
2034,4,2.25,2470,1.0,8,1470,1000,47.6913,2050
2035,3,1.75,1880,1.0,8,1410,470,47.7662,2340
2036,3,1.5,1280,2.0,6,1280,0,47.3344,1070
2037,3,2.0,1350,1.0,7,1350,0,47.7616,1920
2038,3,1.75,1640,1.0,8,1340,300,47.7698,2210
2039,4,2.5,2370,1.0,8,1570,800,47.5327,2550
2040,4,2.25,2330,2.0,8,2330,0,47.7264,2330
2041,3,1.0,1200,1.0,6,1200,0,47.3729,1200
2042,4,2.0,2200,1.0,7,1100,1100,47.565,1410
2043,3,2.75,2660,1.0,8,2660,0,47.7649,2720
2044,3,2.5,1820,2.0,8,1820,0,47.7155,2040
2045,2,1.0,1530,1.0,7,1530,0,47.6833,1530
2046,3,2.25,1880,1.0,8,1480,400,47.5937,2120
2047,3,2.25,1990,2.0,7,1990,0,47.4917,1690
2048,3,2.5,2100,2.0,8,2100,0,47.5334,1890
2049,4,2.25,2100,3.0,8,2100,0,47.6726,1660
2050,3,1.75,1500,1.0,6,1500,0,47.4367,1500
2051,3,1.0,1400,1.0,6,1400,0,47.4798,1070
2052,4,2.75,2960,1.0,8,2360,600,47.4006,1870
2053,4,2.5,3100,2.0,9,3100,0,47.3741,1850
2054,5,2.5,2530,1.0,7,1290,1240,47.61600000000001,2040
2055,4,2.25,2850,2.0,9,2850,0,47.7439,2700
2056,2,1.75,1160,1.0,7,860,300,47.6937,1250
2057,4,1.75,1450,1.5,7,1180,270,47.478,1450
2058,3,1.5,1960,1.5,7,1960,0,47.6768,1880
2059,2,1.0,910,1.0,5,910,0,47.526,1290
2060,2,1.0,910,1.0,5,910,0,47.526,1290
2061,3,2.0,1980,1.5,8,1590,390,47.6847,1760
2062,4,1.5,1580,2.0,7,1580,0,47.3336,1580
2063,3,2.5,1670,1.0,7,1170,500,47.615,1960
2064,5,2.5,2200,2.0,8,2200,0,47.5772,2200
2065,3,1.75,1230,1.0,7,1230,0,47.3171,1690
2066,2,1.0,780,1.0,5,780,0,47.4944,1210
2067,2,1.5,1110,3.0,8,1110,0,47.6931,1110
2068,3,2.5,2790,2.0,9,2790,0,47.7687,2740
2069,4,1.75,1660,1.0,7,1000,660,47.5071,1880
2070,6,2.0,2500,1.0,8,1250,1250,47.5517,1800
2071,3,2.25,1660,2.0,7,1660,0,47.3599,1840
2072,4,2.5,3090,2.0,10,3090,0,47.5932,3100
2073,3,1.0,860,1.0,6,860,0,47.3634,1120
2074,5,2.75,3831,2.0,9,3831,0,47.5919,3850
2075,3,1.0,1980,1.0,7,1080,900,47.7551,1680
2076,6,1.75,2460,1.0,7,1230,1230,47.6721,1560
2077,4,3.25,3330,2.0,9,3330,0,47.5977,3100
2078,3,2.5,1950,2.0,8,1950,0,47.7603,1950
2079,4,2.5,2980,2.0,9,2980,0,47.3999,2630
2080,3,1.0,1010,1.0,7,1010,0,47.3423,1230
2081,2,1.0,1050,1.0,7,1050,0,47.6294,3360
2082,3,1.5,1490,1.0,7,1010,480,47.3431,1570
2083,2,1.0,770,1.0,6,770,0,47.7439,820
2084,3,1.5,1200,1.0,7,1000,200,47.4545,1640
2085,3,2.5,2330,2.0,8,2330,0,47.6022,1830
2086,3,1.75,2000,1.0,8,1400,600,47.4417,1890
2087,2,1.0,820,1.0,6,820,0,47.4163,1410
2088,3,1.75,1390,1.0,6,860,530,47.5517,1390
2089,3,2.0,1890,1.0,8,1890,0,47.6203,2000
2090,4,3.0,3380,1.0,8,2330,1050,47.5501,2500
2091,3,2.5,2320,1.0,8,1380,940,47.7323,2830
2092,3,1.5,1110,1.0,7,1110,0,47.422,1330
2093,4,2.5,2460,1.0,8,1650,810,47.5952,2550
2094,3,1.0,1270,1.0,7,1270,0,47.6874,2260
2095,4,2.5,2320,2.0,8,2320,0,47.7738,2090
2096,3,1.5,1200,1.0,7,1200,0,47.3137,1390
2097,4,1.0,1720,1.5,7,1720,0,47.6791,2140
2098,4,1.75,1650,1.0,8,1650,0,47.6652,1700
2099,2,1.75,1710,1.0,7,1710,0,47.4732,1760
2100,4,2.0,1490,1.0,7,1110,380,47.5949,1330
2101,2,1.0,720,1.0,6,720,0,47.5346,1630
2102,3,3.5,2380,2.0,8,1670,710,47.5137,2540
2103,4,2.5,2760,2.0,7,2760,0,47.4814,2670
2104,4,1.5,1760,1.5,7,1760,0,47.3871,1760
2105,3,2.0,1360,1.0,6,1360,0,47.6879,2530
2106,3,1.75,2010,2.0,7,2010,0,47.4975,1770
2107,3,1.5,2160,2.0,8,1620,540,47.6321,2570
2108,2,2.0,1360,1.0,8,1360,0,47.3804,1160
2109,3,1.0,1150,1.0,7,1150,0,47.727,1210
2110,4,3.5,2710,2.0,8,2710,0,47.7601,1590
2111,4,2.5,2290,2.0,8,2290,0,47.3762,2130
2112,4,3.25,4240,2.0,10,3550,690,47.3241,3590
2113,4,2.25,4470,2.0,10,4470,0,47.6377,3850
2114,2,1.0,970,1.0,7,970,0,47.6444,1180
2115,2,1.0,860,1.0,7,860,0,47.5361,1200
2116,2,1.0,1330,1.0,6,850,480,47.6901,1200
2117,3,1.75,1240,1.0,7,1240,0,47.6522,2060
2118,3,2.5,1330,3.0,8,1330,0,47.6835,1330
2119,2,1.0,720,1.0,6,720,0,47.5195,810
2120,4,2.25,3220,2.0,8,3220,0,47.6381,2500
2121,3,1.5,2120,1.0,7,1060,1060,47.6438,1620
2122,3,1.75,1510,1.0,7,1510,0,47.7321,1480
2123,3,2.0,1850,1.0,7,1850,0,47.6565,1528
2124,3,2.25,2600,1.0,8,1490,1110,47.4326,2450
2125,4,4.25,5180,2.0,12,4280,900,47.5513,5030
2126,4,2.5,1890,2.0,8,1890,0,47.3328,2170
2127,3,2.0,1310,1.0,7,1310,0,47.303,1390
2128,5,3.5,4010,2.0,9,2850,1160,47.6578,2610
2129,4,1.75,1630,1.0,7,1630,0,47.3948,1630
2130,3,2.25,1620,2.0,7,1620,0,47.3577,1640
2131,3,2.0,1770,3.0,8,1770,0,47.6102,1890
2132,3,1.75,1590,1.0,8,1590,0,47.5855,1970
2133,3,1.75,1390,1.0,7,1390,0,47.4183,1460
2134,3,3.75,5400,2.0,11,5400,0,47.6426,1690
2135,3,2.5,2600,2.0,8,2600,0,47.5175,2270
2136,2,1.5,1400,1.0,7,1150,250,47.6681,1530
2137,4,1.75,2140,1.0,8,1410,730,47.622,2080
2138,3,2.5,2000,2.0,8,2000,0,47.3499,2180
2139,3,1.75,1560,1.0,6,780,780,47.719,1320
2140,3,2.0,1920,1.0,7,1300,620,47.7703,2010
2141,3,2.0,1690,1.0,7,940,750,47.5102,2390
2142,4,2.0,3090,1.0,7,1590,1500,47.7275,2560
2143,4,1.5,1790,1.0,7,1020,770,47.6489,1680
2144,4,2.75,2840,1.5,8,1960,880,47.5846,2750
2145,3,1.75,1150,1.0,7,1150,0,47.3766,1540
2146,3,1.0,1090,1.0,6,1090,0,47.3162,1040
2147,3,2.5,2670,2.0,9,2670,0,47.7443,2760
2148,3,2.0,2110,1.5,7,1990,120,47.6645,1620
2149,4,2.0,1730,2.0,8,1730,0,47.7181,1410
2150,2,1.5,1440,1.0,8,1440,0,47.2909,1460
2151,3,1.75,1570,1.0,7,1570,0,47.3207,2000
2152,2,1.0,1050,1.0,7,1050,0,47.3226,1380
2153,2,1.0,970,1.0,6,970,0,47.5102,1280
2154,3,2.5,2200,2.0,8,2200,0,47.4197,2200
2155,4,2.0,1930,1.5,7,1930,0,47.6156,1480
2156,5,5.5,7050,1.0,13,4320,2730,47.6229,5070
2157,3,2.5,1790,2.0,8,1790,0,47.6894,1340
2158,3,1.75,1560,1.0,7,1560,0,47.3674,2100
2159,3,1.5,1720,2.0,8,1720,0,47.6746,2210
2160,3,1.0,1640,1.0,6,1040,600,47.482,1600
2161,2,1.0,740,1.0,6,740,0,47.4481,1500
2162,2,2.75,2090,2.0,8,2090,0,47.4145,1820
2163,3,2.5,2550,2.0,9,2550,0,47.5586,3180
2164,3,1.0,1210,1.0,6,1210,0,47.5551,1070
2165,4,1.75,1440,1.0,8,1440,0,47.63399999999999,3520
2166,4,2.5,2510,1.0,9,1540,970,47.6287,2370
2167,2,1.0,780,1.0,6,780,0,47.5381,1620
2168,3,1.0,1720,1.0,7,1720,0,47.4772,1550
2169,3,4.0,2550,2.0,8,2050,500,47.6415,2340
2170,4,2.5,2286,2.0,8,2286,0,47.5174,2110
2171,3,2.5,1740,2.0,8,1740,0,47.5772,1740
2172,5,2.5,2880,1.0,8,1440,1440,47.5456,2010
2173,3,2.5,1990,2.0,7,1990,0,47.3531,2580
2174,3,1.75,1570,2.0,7,1570,0,47.3876,1580
2175,3,1.0,1270,1.0,7,1270,0,47.4921,1340
2176,2,2.25,1350,2.0,7,1180,170,47.6399,1760
2177,5,3.0,2420,1.0,7,1360,1060,47.536,1840
2178,4,3.5,2770,2.0,8,2770,0,47.7412,1760
2179,4,3.5,2760,2.0,8,2000,760,47.5687,1690
2180,2,1.0,1060,1.0,7,1060,0,47.6896,1420
2181,4,2.5,2160,1.0,8,1440,720,47.6333,1280
2182,3,1.5,1450,1.0,7,1450,0,47.5983,1490
2183,4,2.5,2480,1.0,8,1240,1240,47.7612,2230
2184,4,2.5,2927,2.0,10,2927,0,47.5948,2967
2185,4,2.75,2260,1.0,8,2260,0,47.6342,1870
2186,3,1.5,1240,1.0,7,1240,0,47.3727,2260
2187,6,2.0,2040,1.0,5,2040,0,47.4919,1440
2188,4,3.5,4370,2.0,8,2780,1590,47.24100000000001,2860
2189,2,1.5,1300,1.0,7,1300,0,47.6134,1420
2190,3,1.5,1350,1.0,7,1350,0,47.6587,1840
2191,3,2.25,1810,1.0,8,1810,0,47.5505,1900
2192,4,2.5,2490,2.0,9,2490,0,47.6836,2490
2193,3,1.75,2220,1.0,7,1270,950,47.7762,1490
2194,6,3.0,2480,2.0,8,2480,0,47.6131,2220
2195,3,1.75,1570,1.0,8,1200,370,47.6389,1760
2196,3,2.0,1330,1.0,7,1330,0,47.7181,1580
2197,3,1.0,840,1.0,5,840,0,47.3948,1430
2198,4,1.0,1720,1.5,7,1720,0,47.6719,1580
2199,7,4.5,6210,2.5,11,4760,1450,47.6307,2940
2200,3,1.0,960,1.5,6,960,0,47.5553,1380
2201,2,1.0,1240,1.0,7,1240,0,47.6461,2080
2202,3,3.0,1850,1.0,7,1230,620,47.7717,1970
2203,3,1.75,2260,1.0,7,1130,1130,47.7129,2240
2204,4,3.5,2780,2.0,10,2530,250,47.45399999999999,2724
2205,3,1.0,1140,1.0,7,1140,0,47.7464,1150
2206,5,2.5,2560,2.0,8,2560,0,47.7125,2430
2207,4,2.5,2100,1.0,8,2100,0,47.3338,2310
2208,4,2.5,2300,2.0,7,2300,0,47.3683,1820
2209,2,1.5,950,2.0,7,850,100,47.6005,950
2210,4,2.75,2990,2.0,9,2990,0,47.7101,2990
2211,4,2.0,1540,1.5,7,1540,0,47.2056,1480
2212,3,2.25,1530,1.0,7,1240,290,47.462,1500
2213,5,3.25,3570,2.0,7,3570,0,47.5933,2690
2214,5,4.25,4230,2.0,10,3450,780,47.6866,2650
2215,5,2.0,1210,2.0,7,1210,0,47.2848,1510
2216,3,2.0,1850,1.0,7,1850,0,47.7671,1770
2217,3,1.5,1110,1.0,7,1110,0,47.676,1900
2218,4,3.0,3230,2.0,9,3230,0,47.4141,1600
2219,3,1.5,1460,1.0,7,980,480,47.3954,1400
2220,3,1.75,1820,1.0,8,1620,200,47.6737,2330
2221,4,3.0,2750,1.0,8,1630,1120,47.7134,2440
2222,1,1.0,620,1.0,5,620,0,47.4095,1300
2223,3,1.75,1300,1.0,7,1300,0,47.3162,1640
2224,4,2.75,1930,1.0,8,1180,750,47.7502,1880
2225,4,3.75,4260,2.0,10,4260,0,47.6739,1950
2226,3,1.0,1040,1.0,7,1040,0,47.6178,1170
2227,3,1.0,1260,1.0,7,960,300,47.6947,1540
2228,3,2.5,2460,2.0,9,2460,0,47.691,2540
2229,3,2.5,2060,1.0,8,1050,1010,47.5627,2690
2230,4,1.75,2030,1.0,9,1130,900,47.4603,2040
2231,2,1.0,1210,1.0,7,1000,210,47.6482,1840
2232,4,2.25,1530,1.0,7,1030,500,47.5589,1710
2233,4,2.5,3030,1.0,8,1660,1370,47.4598,2740
2234,3,2.5,2740,2.0,9,2740,0,47.3835,2690
2235,3,1.75,1390,1.0,7,930,460,47.6944,1230
2236,3,2.5,2849,2.0,10,2849,0,47.6487,3190
2237,4,2.5,3000,2.0,8,3000,0,47.7623,3000
2238,4,2.0,2680,1.0,8,1460,1220,47.4286,2100
2239,5,2.5,2310,1.0,7,1300,1010,47.7212,1930
2240,2,1.5,1030,1.0,7,830,200,47.6455,1250
2241,3,1.0,1320,1.0,7,1320,0,47.7748,1320
2242,3,1.0,1100,1.0,6,840,260,47.7011,1280
2243,5,3.0,4530,1.5,9,3200,1330,47.7702,3430
2244,4,1.0,1440,1.5,7,1440,0,47.7529,1440
2245,3,1.0,1400,1.0,6,1400,0,47.719,1430
2246,3,2.5,2490,2.0,9,2490,0,47.6716,2900
2247,3,1.5,2170,1.0,10,1130,1040,47.6307,3130
2248,3,1.5,1370,1.0,7,1370,0,47.5409,1730
2249,4,2.5,2840,2.0,10,2840,0,47.6274,2540
2250,3,1.75,1940,1.5,8,1940,0,47.2062,1650
2251,3,1.0,1590,2.0,7,1590,0,47.5217,1600
2252,3,1.75,2320,2.0,8,2040,280,47.643,3110
2253,3,2.5,1990,2.0,10,1520,470,47.6361,1710
2254,3,2.5,2095,2.0,7,2095,0,47.3523,1805
2255,3,1.0,1320,1.0,7,1320,0,47.5048,1720
2256,2,1.75,1270,1.0,7,890,380,47.4438,2020
2257,3,2.5,2620,2.0,9,2620,0,47.7211,2620
2258,3,1.0,1040,1.0,6,800,240,47.3273,820
2259,3,1.75,1660,1.0,7,1660,0,47.3609,2150
2260,3,2.5,2540,2.0,9,2540,0,47.4965,2380
2261,4,2.0,2930,1.5,8,2930,0,47.2957,1960
2262,2,1.0,1310,1.0,7,910,400,47.6784,1320
2263,6,4.5,4800,2.0,10,3580,1220,47.6259,2180
2264,4,1.5,1450,1.0,6,1450,0,47.3613,1060
2265,3,3.5,4240,2.0,10,3500,740,47.5614,3120
2266,4,2.5,1840,2.0,9,1840,0,47.6662,2120
2267,3,2.0,1710,1.0,8,1260,450,47.3473,1760
2268,3,2.5,1690,1.0,7,1310,380,47.7381,1690
2269,3,1.75,2210,1.0,7,1400,810,47.4968,2220
2270,4,3.5,4380,1.0,11,4380,0,47.6587,5170
2271,5,2.75,3090,1.0,9,1600,1490,47.5342,2280
2272,3,2.5,2680,1.0,8,1440,1240,47.6538,2320
2273,5,2.5,3470,2.0,8,3470,0,47.624,2220
2274,3,2.5,2420,2.0,8,2420,0,47.3835,1950
2275,4,2.5,2190,1.0,8,1250,940,47.3131,2100
2276,3,1.0,1000,1.0,7,1000,0,47.52,1140
2277,3,2.5,1710,2.0,8,1710,0,47.75,1610
2278,4,3.0,1920,1.0,7,1920,0,47.4805,1530
2279,3,1.5,1640,1.0,7,1640,0,47.495,1540
2280,3,2.5,2420,2.0,9,2420,0,47.772,2780
2281,3,1.75,2080,1.0,7,1220,860,47.4536,1770
2282,4,2.5,3080,2.0,9,3080,0,47.6197,2920
2283,5,2.5,4320,1.0,8,2160,2160,47.4009,2480
2284,5,1.0,1500,2.0,7,1500,0,47.6811,1350
2285,4,2.5,1790,2.0,7,1790,0,47.4829,1950
2286,4,1.75,2180,1.0,7,1560,620,47.757,1810
2287,3,1.0,910,1.0,7,910,0,47.6828,1370
2288,3,1.0,940,1.0,6,940,0,47.6231,1250
2289,3,2.0,1010,1.5,7,1010,0,47.6066,1330
2290,3,2.5,2120,1.0,9,2120,0,47.4089,1304
2291,4,2.0,1530,2.0,7,1530,0,47.4692,1500
2292,3,2.0,1270,3.0,8,1270,0,47.6929,1180
2293,3,1.0,1240,1.0,7,1240,0,47.4363,1250
2294,4,2.0,1220,2.0,7,1220,0,47.6133,1220
2295,4,2.5,2163,2.0,7,2163,0,47.2736,1760
2296,4,2.0,1510,1.0,7,870,640,47.5972,1420
2297,5,1.75,2860,1.0,8,1430,1430,47.7385,1920
2298,2,1.0,780,1.0,6,780,0,47.5423,1270
2299,2,1.0,1490,1.0,7,1090,400,47.6296,1590
2300,3,1.75,1940,1.0,7,1940,0,47.4214,2060
2301,3,2.0,1190,1.0,7,1190,0,47.5057,1920
2302,3,2.5,1390,2.0,7,1390,0,47.5303,2340
2303,2,1.5,1070,3.0,8,1070,0,47.6699,1320
2304,3,2.5,1720,2.0,8,1720,0,47.569,1780
2305,4,2.5,3680,2.0,10,3680,0,47.3543,3310
2306,3,2.5,1830,2.0,8,1830,0,47.3116,1770
2307,3,1.5,1500,1.0,7,1500,0,47.7276,1420
2308,4,2.5,2500,2.0,8,2500,0,47.3666,2690
2309,3,2.25,2570,1.0,9,2570,0,47.6854,2570
2310,2,1.0,810,1.0,6,810,0,47.5635,900
2311,4,3.5,4210,2.0,10,4210,0,47.5905,3860
2312,4,2.5,2880,1.0,8,1780,1100,47.6658,2500
2313,3,1.0,1290,1.0,7,1290,0,47.3004,1690
2314,4,1.0,1320,1.5,7,1320,0,47.6145,1260
2315,4,2.5,1160,1.0,7,1160,0,47.7643,1570
2316,3,1.75,1520,1.0,7,1520,0,47.457,1650
2317,3,1.0,1370,1.0,7,1370,0,47.4879,1370
2318,4,2.75,3010,1.0,8,1560,1450,47.7336,2110
2319,3,1.75,1330,1.0,7,1330,0,47.6599,1510
2320,2,0.75,1260,1.5,6,1080,180,47.6843,2660
2321,3,2.5,1690,2.0,8,1140,550,47.5404,1640
2322,4,1.75,3420,1.0,8,1770,1650,47.7081,2450
2323,3,1.75,1270,1.5,7,1270,0,47.5976,1490
2324,4,2.5,2910,2.0,9,2910,0,47.5451,2530
2325,3,1.75,1300,1.0,7,1300,0,47.1983,1300
2326,3,1.75,1360,1.0,7,1360,0,47.7583,1360
2327,4,2.5,2500,1.0,8,1300,1200,47.336000000000006,2500
2328,4,1.75,2260,1.0,8,1450,810,47.6555,2980
2329,3,1.0,1060,1.0,7,1060,0,47.365,1500
2330,3,1.0,1100,1.0,7,1100,0,47.5309,1630
2331,5,3.25,3010,1.5,8,2010,1000,47.4564,2450
2332,4,2.75,2730,1.0,8,1530,1200,47.7726,2310
2333,4,2.75,3880,2.0,7,3880,0,47.6777,2620
2334,3,1.0,950,1.0,7,950,0,47.3188,1360
2335,3,1.75,1500,1.0,7,1500,0,47.7293,1970
2336,3,1.75,2160,1.0,8,1260,900,47.5346,2090
2337,3,2.25,1960,2.0,7,1750,210,47.5419,1760
2338,3,1.0,1100,1.5,6,1100,0,47.5697,1100
2339,2,2.5,2320,1.0,8,2320,0,47.7226,1680
2340,3,1.0,2020,1.0,6,1760,260,47.7552,1780
2341,5,2.0,2020,2.0,7,2020,0,47.5799,1960
2342,6,4.0,5330,2.0,11,3950,1380,47.5503,4590
2343,3,2.0,1460,1.0,7,730,730,47.67,1780
2344,3,2.5,1530,2.0,8,1530,0,47.5691,1720
2345,4,2.0,1960,2.0,7,1960,0,47.7494,1580
2346,4,2.25,2190,2.0,8,2190,0,47.3742,2170
2347,3,2.5,1690,2.0,7,1690,0,47.3552,1830
2348,5,2.0,2330,1.0,7,1190,1140,47.7325,1830
2349,2,1.0,800,1.0,6,800,0,47.4959,1100
2350,3,1.5,1030,1.0,6,1030,0,47.5492,1420
2351,3,2.0,1630,1.0,7,1630,0,47.7326,1470
2352,2,2.0,1340,1.5,8,1340,0,47.6384,2210
2353,3,1.0,1010,1.0,7,1010,0,47.6169,1230
2354,2,1.0,1060,1.0,6,1060,0,47.4305,2320
2355,3,2.75,1850,1.0,8,1850,0,47.7128,2470
2356,3,1.0,1090,1.0,6,1090,0,47.3155,1090
2357,3,2.5,1970,2.0,8,1970,0,47.7397,2640
2358,4,2.5,3220,2.0,10,3220,0,47.6854,3090
2359,3,2.5,2050,2.0,8,2050,0,47.5689,2050
2360,4,2.5,2230,2.0,7,2230,0,47.3287,2230
2361,4,2.25,3440,2.0,9,3440,0,47.7241,3250
2362,4,3.5,4030,2.0,10,4030,0,47.4619,1830
2363,3,2.25,1780,3.0,8,1570,210,47.6413,1470
2364,2,2.0,1480,1.0,7,740,740,47.5317,1230
2365,3,1.0,1140,1.5,6,1140,0,47.5122,1140
2366,4,2.5,3080,2.0,9,3080,0,47.3828,2740
2367,4,2.5,1990,2.0,10,1990,0,47.56100000000001,2580
2368,2,1.0,860,1.0,6,860,0,47.4801,990
2369,4,1.75,2200,1.5,6,1400,800,47.4945,1520
2370,5,2.75,2130,1.0,7,1300,830,47.5272,2130
2371,4,2.5,2230,2.0,8,2230,0,47.2082,2270
2372,4,2.25,2500,1.0,7,1800,700,47.7318,2500
2373,3,2.5,1730,2.0,8,1730,0,47.5668,1730
2374,3,1.75,2020,2.0,7,2020,0,47.4189,1810
2375,4,3.25,3100,2.0,9,2090,1010,47.6385,2110
2376,3,1.75,1610,1.0,7,1610,0,47.3413,1450
2377,2,1.0,850,1.0,6,850,0,47.5198,850
2378,4,1.0,1360,1.5,7,1360,0,47.6854,1710
2379,4,2.5,2650,1.0,9,2330,320,47.7537,3020
2380,3,1.0,1050,1.0,7,1050,0,47.6756,1580
2381,4,1.0,1170,1.0,6,1170,0,47.492,1100
2382,3,1.0,1150,1.0,6,1150,0,47.3865,1492
2383,3,1.0,1150,1.0,6,1150,0,47.3865,1492
2384,3,1.0,910,1.5,5,910,0,47.2068,1400
2385,2,1.0,1070,1.0,7,1070,0,47.7315,1680
2386,3,2.25,2010,1.0,8,1330,680,47.6912,2080
2387,4,3.25,3230,1.5,7,1750,1480,47.6702,1730
2388,3,2.5,2070,1.0,8,1540,530,47.5936,2620
2389,2,1.0,1050,1.0,7,1050,0,47.5471,1890
2390,4,3.5,4540,2.0,11,4200,340,47.5445,3990
2391,3,1.5,1390,2.0,7,1390,0,47.5506,1100
2392,2,1.0,1740,1.0,7,950,790,47.5541,1270
2393,3,2.0,2168,2.0,7,2168,0,47.4933,2168
2394,4,3.5,4140,2.0,11,4140,0,47.5261,4140
2395,4,2.5,2440,1.0,8,1560,880,47.3895,2090
2396,2,1.5,1068,2.0,7,1068,0,47.7527,1078
2397,4,1.0,1350,1.0,7,1350,0,47.4269,1320
2398,3,2.25,1400,3.0,8,1400,0,47.7147,1490
2399,3,1.75,1300,1.0,7,1300,0,47.7024,1290
2400,3,1.75,1580,1.0,7,1580,0,47.2598,1480
2401,3,2.5,2330,2.0,8,2330,0,47.5622,1980
2402,6,5.0,7100,2.5,13,5240,1860,47.6427,3130
2403,3,1.75,1230,1.0,7,1230,0,47.4431,1250
2404,4,3.5,2770,2.0,9,2770,0,47.6469,3410
2405,3,2.25,1460,2.0,7,1140,320,47.6601,1460
2406,3,1.0,1160,1.0,7,1160,0,47.7427,1160
2407,3,2.0,2180,1.0,7,1100,1080,47.657,1470
2408,3,1.75,1560,1.0,6,780,780,47.6501,1560
2409,3,1.75,2720,1.5,9,2720,0,47.7092,2560
2410,3,2.5,2150,2.0,8,2150,0,47.4621,2400
2411,4,1.75,2270,1.0,8,1300,970,47.7637,2380
2412,3,2.5,1690,2.0,7,1690,0,47.3691,2610
2413,3,1.75,1460,1.0,7,1460,0,47.7755,2200
2414,4,1.75,1600,1.0,8,1130,470,47.701,1090
2415,2,1.0,1040,1.0,6,1040,0,47.6823,1640
2416,2,1.0,800,1.0,6,800,0,47.5525,1280
2417,2,1.0,990,1.0,4,990,0,47.3577,1560
2418,4,1.5,1820,1.0,7,1380,440,47.5767,1450
2419,2,1.0,910,1.0,7,910,0,47.6733,1050
2420,2,1.0,930,1.0,5,930,0,47.4966,930
2421,4,2.5,3430,2.0,9,3430,0,47.6842,1530
2422,3,2.25,2440,1.0,8,1830,610,47.6141,2730
2423,3,2.0,2330,1.5,6,1600,730,47.5135,1380
2424,2,1.0,1400,1.5,6,1100,300,47.4724,2250
2425,2,1.0,1140,1.0,6,990,150,47.4521,2320
2426,3,1.0,1120,1.0,7,1120,0,47.5103,1410
2427,3,1.5,1970,1.0,7,1680,290,47.7562,2200
2428,3,2.5,1940,2.0,8,1940,0,47.4479,2070
2429,3,1.0,1240,1.5,7,1240,0,47.5986,1680
2430,3,2.5,3190,2.0,9,3190,0,47.5047,2970
2431,4,1.75,1670,1.0,7,1390,280,47.5524,1720
2432,4,2.0,2070,1.0,7,2070,0,47.566,1300
2433,4,2.0,2070,1.0,7,2070,0,47.566,1300
2434,3,2.0,1980,1.5,6,1070,910,47.6839,1330
2435,4,2.5,2550,1.0,7,1300,1250,47.7682,2080
2436,2,1.0,810,1.0,6,810,0,47.5495,990
2437,3,2.5,3590,1.0,9,2950,640,47.595,1620
2438,3,1.75,2360,1.0,7,1180,1180,47.6902,1660
2439,4,2.5,2100,2.0,8,2100,0,47.4478,2060
2440,2,2.0,1310,2.0,6,1310,0,47.3502,1360
2441,3,2.5,1830,2.5,7,1830,0,47.7613,1340
2442,3,1.75,2920,1.0,8,1850,1070,47.7666,1540
2443,4,3.25,3160,2.0,9,3160,0,47.7001,3450
2444,2,1.75,1330,1.0,8,1330,0,47.3822,1220
2445,2,1.0,1270,1.0,5,1270,0,47.3651,1870
2446,3,1.0,1040,1.0,6,1040,0,47.3265,1040
2447,3,1.75,1930,1.0,8,1130,800,47.6516,1870
2448,3,2.0,1510,1.0,7,1510,0,47.2078,1370
2449,3,1.75,1320,1.0,7,1320,0,47.312,1660
2450,4,1.5,1680,1.0,7,1130,550,47.7565,1770
2451,3,3.25,3410,2.0,8,3410,0,47.6929,1660
2452,2,1.5,1900,1.0,7,1500,400,47.5834,2130
2453,4,2.5,1690,1.0,7,1080,610,47.3001,1690
2454,3,1.0,1040,1.0,7,1040,0,47.7348,1420
2455,3,3.5,3840,2.0,9,3840,0,47.7322,3810
2456,3,2.5,1630,1.0,8,1320,310,47.4224,1650
2457,2,2.0,970,1.0,6,970,0,47.5073,1850
2458,2,1.0,770,1.0,6,770,0,47.5324,1140
2459,2,2.0,1960,1.0,7,980,980,47.5629,1240
2460,4,2.75,2920,2.0,8,2920,0,47.4909,3030
2461,3,2.5,1730,2.0,8,1730,0,47.4614,1750
2462,3,2.5,1570,2.0,7,1570,0,47.7456,1970
2463,4,3.0,2800,2.0,8,2800,0,47.3543,3610
2464,4,2.0,1580,2.0,6,1580,0,47.5848,1190
2465,2,1.0,1220,1.0,7,920,300,47.6823,1270
2466,3,1.75,1720,1.0,7,1140,580,47.3175,1120
2467,2,2.25,1100,2.0,9,1100,0,47.5663,1100
2468,3,2.0,1010,1.0,7,1010,0,47.4046,1540
2469,3,2.0,1010,1.0,7,1010,0,47.4046,1540
2470,2,1.0,770,1.0,6,770,0,47.5654,1100
2471,1,1.0,480,1.0,5,480,0,47.5253,890
2472,2,1.0,870,1.0,6,870,0,47.5038,1370
2473,5,1.75,2660,1.5,7,1670,990,47.6945,1570
2474,2,1.75,1230,2.0,8,1230,0,47.5475,1380
2475,3,2.5,3100,1.0,10,3100,0,47.7635,3000
2476,2,2.0,1750,2.0,8,1750,0,47.5169,1650
2477,4,2.75,4120,1.0,8,2060,2060,47.5914,3680
2478,3,1.75,1260,1.0,6,840,420,47.772,1340
2479,3,2.5,1960,1.0,8,980,980,47.5655,1440
2480,2,1.75,1530,2.0,7,1260,270,47.6755,1470
2481,4,3.75,4410,3.0,11,3570,840,47.5888,2770
2482,4,2.75,2290,2.0,7,2170,120,47.6746,1910
2483,2,1.5,1170,3.0,7,1170,0,47.6607,1170
2484,5,2.5,1970,2.0,7,1970,0,47.1944,1970
2485,3,1.75,1330,1.0,6,720,610,47.5102,1770
2486,3,1.0,1030,1.0,7,1030,0,47.5118,1030
2487,6,2.75,2040,1.0,7,1100,940,47.61600000000001,2230
2488,3,2.0,1540,1.0,8,1540,0,47.7041,1510
2489,4,1.0,1920,1.0,7,1220,700,47.4502,1490
2490,3,2.5,1870,2.0,7,1870,0,47.3992,2190
2491,3,1.5,1690,1.0,7,1690,0,47.4531,1990
2492,3,2.5,3160,2.0,9,3160,0,47.3401,2110
2493,3,1.5,1370,1.0,7,1080,290,47.4167,1400
2494,4,1.75,1820,1.0,7,1150,670,47.4567,1610
2495,5,3.75,3880,2.0,7,3880,0,47.4811,2160
2496,5,1.75,2350,1.0,8,1510,840,47.6225,2220
2497,4,1.75,2350,1.0,8,1350,1000,47.6879,2060
2498,3,2.5,1350,2.0,7,1350,0,47.6099,1900
2499,6,1.5,1680,1.5,7,1680,0,47.6798,1890
2500,3,2.25,1950,1.0,7,1350,600,47.7538,1300
2501,4,1.0,1440,1.0,6,1080,360,47.5328,1620
2502,3,1.0,1180,1.5,7,1180,0,47.7529,1470
2503,4,2.5,2040,1.0,8,1610,430,47.636,1730
2504,3,1.0,1000,1.0,7,1000,0,47.7142,1000
2505,2,1.0,1280,1.5,6,1280,0,47.3096,1520
2506,5,2.5,2200,1.0,7,1400,800,47.3073,1360
2507,4,2.0,1840,1.5,6,1080,760,47.5297,1170
2508,4,1.5,2890,2.0,8,2090,800,47.5682,2550
2509,3,1.75,1290,1.0,7,1290,0,47.7598,1770
2510,2,1.0,1140,1.5,6,1140,0,47.5642,1190
2511,3,1.75,1750,1.0,8,1750,0,47.6995,2060
2512,1,1.0,620,1.0,6,620,0,47.4697,1160
2513,3,1.5,1440,1.0,7,1440,0,47.5418,1440
2514,3,2.0,1160,1.0,7,1160,0,47.7341,1130
2515,3,1.75,1720,1.0,7,1720,0,47.4709,1840
2516,2,1.0,880,1.0,6,880,0,47.5573,1080
2517,3,1.0,860,1.0,6,860,0,47.4987,1140
2518,3,1.0,860,1.0,6,860,0,47.4987,1140
2519,3,1.0,1210,1.5,7,1210,0,47.5403,1160
2520,4,2.5,2490,2.0,9,2490,0,47.6161,2440
2521,3,2.0,1870,1.5,7,1060,810,47.6964,1640
2522,4,1.75,1840,1.0,7,980,860,47.708,1520
2523,3,3.25,1410,3.0,8,1410,0,47.6981,1410
2524,2,1.0,1050,1.0,7,880,170,47.6172,1620
2525,2,2.0,1400,1.0,8,1400,0,47.7262,1400
2526,4,3.25,2885,2.0,8,2885,0,47.5174,1910
2527,4,2.5,3020,1.0,8,1710,1310,47.4298,1900
2528,3,2.5,2090,1.0,8,1360,730,47.3537,1750
2529,3,2.75,2390,1.0,8,1450,940,47.7339,2390
2530,3,2.0,1320,1.0,7,1320,0,47.3904,1600
2531,3,1.75,1400,1.0,8,1400,0,47.7413,2200
2532,2,2.5,1560,1.0,5,780,780,47.4749,1010
2533,5,2.0,2300,2.5,8,2300,0,47.7556,2030
2534,2,1.0,820,1.0,6,820,0,47.5298,1240
2535,4,1.0,1540,1.5,7,1090,450,47.6754,1590
2536,3,2.5,1690,2.0,7,1690,0,47.3575,1830
2537,3,1.5,1060,1.0,7,1060,0,47.5329,1120
2538,2,1.0,1280,1.0,7,1280,0,47.5179,1270
2539,4,2.75,3670,2.0,10,3670,0,47.5581,3370
2540,4,2.0,2600,1.0,8,1410,1190,47.381,2600
2541,4,2.5,2910,1.0,8,1910,1000,47.6495,2760
2542,3,1.75,2420,2.0,8,2420,0,47.6525,2970
2543,3,1.0,960,1.0,7,960,0,47.5611,1460
2544,3,1.0,960,1.0,7,960,0,47.5611,1460
2545,3,1.0,1010,1.0,6,1010,0,47.6874,1470
2546,2,2.25,1550,2.0,8,1550,0,47.5394,1420
2547,4,3.25,1980,1.0,8,1340,640,47.6883,1980
2548,3,1.0,1130,1.0,7,1130,0,47.7254,1410
2549,3,1.5,1300,1.0,7,1300,0,47.6889,1300
2550,3,1.5,1610,1.0,7,1610,0,47.2025,1410
2551,4,2.5,3530,2.0,9,3530,0,47.7285,3750
2552,3,1.75,1270,1.0,7,1270,0,47.6647,1270
2553,3,2.25,1420,3.0,8,1420,0,47.6534,1500
2554,3,1.75,1820,2.0,8,1820,0,47.5271,2030
2555,3,1.75,1400,1.0,7,1400,0,47.5926,2540
2556,3,1.75,1330,1.0,7,1330,0,47.3304,1330
2557,4,2.5,3280,2.0,9,3280,0,47.6711,3200
2558,3,1.75,1580,1.0,7,1210,370,47.6069,2600
2559,3,1.0,1460,1.0,7,1460,0,47.4434,2250
2560,4,2.75,3090,1.0,9,1800,1290,47.6339,2380
2561,3,1.5,1690,1.0,7,1210,480,47.3857,1450
2562,5,3.75,3490,1.0,10,1940,1550,47.5479,3410
2563,3,2.5,2850,2.0,10,2850,0,47.7376,3340
2564,5,2.75,2600,2.0,8,2600,0,47.7348,1600
2565,4,2.75,2600,2.0,8,1960,640,47.5656,1990
2566,2,1.0,1340,1.0,7,890,450,47.697,1380
2567,3,2.0,1290,1.0,7,1290,0,47.3175,1580
2568,3,2.5,2030,2.0,8,2030,0,47.5718,2000
2569,3,2.75,3610,1.5,8,3130,480,47.3351,2630
2570,5,1.0,1880,1.5,6,1360,520,47.566,1420
2571,3,1.75,1290,1.0,7,1290,0,47.6707,1840
2572,4,2.0,1400,1.5,6,1400,0,47.4625,1400
2573,2,1.5,1800,1.0,7,1240,560,47.302,2010
2574,3,1.0,1490,1.0,7,1490,0,47.4901,1490
2575,4,2.5,3180,2.0,11,3180,0,47.5382,3070
2576,3,1.75,1330,1.0,7,1330,0,47.3411,1330
2577,4,1.75,1720,1.0,8,1720,0,47.4654,1840
2578,0,2.5,1810,2.0,7,1810,0,47.3493,1810
2579,3,1.0,1140,1.0,6,1140,0,47.4768,960
2580,5,1.75,2110,1.5,7,1250,860,47.6745,1720
2581,3,1.75,1600,1.0,8,1600,0,47.6293,1970
2582,3,1.75,1370,1.0,6,1370,0,47.6774,1580
2583,3,1.75,1370,1.0,6,1370,0,47.6774,1580
2584,2,1.0,880,1.0,7,880,0,47.6575,1880
2585,5,2.75,2130,1.0,7,1100,1030,47.5271,1340
2586,4,1.75,1910,1.0,7,1910,0,47.6131,1500
2587,2,1.0,1170,1.0,7,1170,0,47.7497,1170
2588,3,2.5,2630,2.0,9,2630,0,47.7035,2630
2589,4,2.75,2150,1.0,8,1340,810,47.266000000000005,2260
2590,1,1.0,900,1.0,6,900,0,47.7019,1830
2591,1,1.0,900,1.0,6,900,0,47.7019,1830
2592,2,1.75,1490,1.0,7,1490,0,47.6246,2280
2593,4,2.5,2790,2.0,8,2790,0,47.7647,1590
2594,3,2.25,1590,2.0,8,1590,0,47.6477,2470
2595,3,1.0,1320,1.0,7,1320,0,47.5705,1480
2596,4,2.5,2310,2.0,8,2310,0,47.3287,1850
2597,3,1.75,1440,1.0,8,1440,0,47.7163,1990
2598,2,1.0,1150,1.0,6,1060,90,47.4935,1350
2599,3,1.5,1570,1.5,6,1570,0,47.2021,1400
2600,4,1.75,2410,1.0,7,1600,810,47.7341,1850
2601,5,2.5,3120,2.0,11,3120,0,47.6142,3390
2602,3,1.0,860,1.0,6,860,0,47.3677,1010
2603,3,2.0,1300,1.5,7,1300,0,47.4839,1480
2604,4,2.5,2300,2.0,8,2300,0,47.6454,2640
2605,4,3.0,3080,2.0,10,3080,0,47.334,3200
2606,4,2.25,2670,1.0,8,1610,1060,47.5623,2470
2607,3,1.0,1220,1.0,6,1220,0,47.5767,1490
2608,3,2.0,2420,1.0,9,1500,920,47.7074,2955
2609,3,2.5,1870,2.0,7,1870,0,47.3986,2190
2610,4,3.0,1810,2.0,7,1810,0,47.5691,1670
2611,4,2.5,2590,2.0,9,2590,0,47.738,2660
2612,5,3.25,3830,2.0,9,3830,0,47.6843,3950
2613,3,1.5,1280,3.0,7,1280,0,47.7162,1420
2614,2,2.5,2510,2.0,10,2510,0,47.7525,3080
2615,2,1.0,910,1.0,5,910,0,47.3752,2050
2616,2,1.0,1650,1.0,7,1090,560,47.6992,1300
2617,2,1.0,1280,1.0,6,640,640,47.5341,1630
2618,4,2.5,2980,2.0,9,2980,0,47.7354,2920
2619,3,1.75,1730,1.0,7,1480,250,47.6978,1730
2620,4,2.0,2070,1.0,7,1180,890,47.7058,2390
2621,1,1.75,750,1.0,4,550,200,47.4756,2020
2622,2,1.0,1570,1.0,7,1570,0,47.2077,1660
2623,3,1.75,2700,1.0,8,1560,1140,47.5834,3010
2624,3,1.75,1520,1.0,7,1520,0,47.473,1590
2625,3,1.75,1520,1.0,7,1520,0,47.473,1590
2626,2,1.0,860,1.0,7,860,0,47.508,1200
2627,3,1.0,1010,1.0,7,1010,0,47.49,1440
2628,3,1.75,1610,1.0,8,1310,300,47.7588,2210
2629,4,2.5,2350,1.0,10,2350,0,47.6411,2700
2630,3,1.5,1360,1.0,7,1360,0,47.4143,1360
2631,3,1.0,1180,1.0,6,1180,0,47.4947,1180
2632,4,1.0,1560,1.0,7,1170,390,47.5093,1570
2633,4,2.5,3300,2.0,8,3300,0,47.7657,3030
2634,2,1.0,1610,1.0,7,1610,0,47.5095,2100
2635,4,2.25,1810,2.0,7,1810,0,47.7319,1460
2636,3,2.5,3050,1.5,8,1950,1100,47.6772,1890
2637,3,2.0,1540,2.0,8,1540,0,47.5479,1540
2638,3,1.0,1380,1.0,7,1380,0,47.5131,1200
2639,3,1.75,1570,1.0,7,1570,0,47.2016,1650
2640,5,2.0,2540,1.0,7,1480,1060,47.7754,2000
2641,5,2.25,2340,1.0,7,1170,1170,47.448,1650
2642,4,2.5,2850,2.0,9,2850,0,47.6747,2440
2643,3,2.0,2360,2.0,8,1560,800,47.5433,2000
2644,3,1.5,1610,2.0,7,1610,0,47.7527,1610
2645,3,2.0,2420,1.0,7,1210,1210,47.4511,2650
2646,3,2.5,1410,1.0,6,1410,0,47.7432,1410
2647,6,2.75,4430,2.0,10,2680,1750,47.5462,3530
2648,4,2.25,2290,1.0,8,1550,740,47.4434,2320
2649,3,1.0,1370,1.5,7,1370,0,47.6857,1590
2650,4,1.75,2480,1.0,7,1390,1090,47.584,2440
2651,2,1.0,1000,1.0,6,1000,0,47.6742,1490
2652,2,1.0,1060,1.0,7,960,100,47.6721,1570
2653,3,2.5,1730,2.0,7,1730,0,47.4317,1730
2654,4,2.5,2810,2.0,9,2810,0,47.4045,2810
2655,2,1.0,880,1.0,7,880,0,47.6848,1150
2656,3,1.0,1040,1.5,7,1040,0,47.7444,1880
2657,3,2.5,2850,2.0,9,2850,0,47.2848,2850
2658,3,1.75,1480,1.0,7,1480,0,47.1967,1130
2659,3,1.0,1250,1.0,7,1030,220,47.5292,1130
2660,2,1.0,930,1.0,6,730,200,47.5598,1970
2661,3,2.0,1990,1.0,7,1130,860,47.6572,1710
2662,3,3.0,2031,2.0,9,2031,0,47.3058,2390
2663,3,2.0,1590,1.0,8,1590,0,47.4365,2780
2664,3,2.5,2610,2.0,10,2610,0,47.5535,3140
2665,2,1.75,1670,2.0,7,1670,0,47.5862,1340
2666,4,3.5,4150,2.0,11,4150,0,47.6746,3330
2667,2,1.5,1280,2.0,8,1200,80,47.6741,1390
2668,5,3.25,3690,2.0,9,3690,0,47.7672,2290
2669,2,2.25,1230,2.0,8,1020,210,47.6191,1270
2670,4,1.5,1580,1.0,6,790,790,47.4971,1320
2671,2,1.0,1020,1.0,6,1020,0,47.5558,1530
2672,2,1.5,1510,1.0,7,1510,0,47.4419,1590
2673,4,2.5,2600,2.0,8,2600,0,47.4865,2830
2674,4,1.75,2260,1.5,7,1360,900,47.5122,1410
2675,4,3.25,4060,2.0,9,4060,0,47.7615,3100
2676,3,3.0,2790,2.0,10,2370,420,47.5466,3140
2677,3,1.0,1290,1.5,7,1290,0,47.6951,1630
2678,2,1.5,720,1.0,6,720,0,47.5225,790
2679,3,2.0,960,1.0,6,960,0,47.4852,1460
2680,3,1.0,1570,1.5,8,1570,0,47.7686,2010
2681,3,2.5,3070,1.0,9,1720,1350,47.3716,2020
2682,3,1.5,1540,2.0,8,1540,0,47.6138,1590
2683,2,1.5,1440,2.0,7,1440,0,47.7698,1440
2684,2,1.0,1330,1.5,6,1330,0,47.4824,1210
2685,4,2.0,2480,1.5,7,1470,1010,47.5686,1500
2686,3,1.0,1270,1.0,7,1270,0,47.5351,1780
2687,3,3.0,2880,2.0,9,2220,660,47.6155,1910
2688,3,2.0,1560,1.0,7,790,770,47.6587,1450
2689,5,2.0,2600,1.5,6,1400,1200,47.6691,1700
2690,5,2.75,2660,1.0,8,1470,1190,47.5667,3280
2691,3,2.25,2030,1.0,7,1190,840,47.6939,1950
2692,4,1.5,1930,2.0,7,1930,0,47.345,1580
2693,3,2.75,3210,2.0,10,3210,0,47.3357,2870
2694,3,2.0,1530,1.0,7,1530,0,47.4529,1960
2695,2,1.0,860,1.0,7,860,0,47.5697,1130
2696,5,2.25,3580,2.0,9,3580,0,47.5364,3390
2697,3,2.5,2150,2.0,8,2150,0,47.5893,2280
2698,3,2.5,2790,2.0,9,2790,0,47.673,2900
2699,3,3.25,1410,3.0,8,1410,0,47.698,1410
2700,4,2.25,4250,1.0,9,2380,1870,47.5453,3460
2701,3,2.5,1760,2.0,8,1760,0,47.2672,1920
2702,3,2.25,2100,2.0,8,2100,0,47.3833,2730
2703,4,2.0,2200,1.0,7,1100,1100,47.464,1790
2704,3,1.0,1230,1.0,7,1230,0,47.5553,1510
2705,3,3.0,2240,2.0,7,2240,0,47.4886,1650
2706,3,1.75,1940,1.0,7,1290,650,47.4361,1900
2707,5,2.25,2060,2.5,8,2060,0,47.66,1740
2708,3,1.75,1520,1.0,7,1140,380,47.7358,1910
2709,5,3.5,3450,2.0,9,3450,0,47.2123,2570
2710,4,1.75,1880,1.0,7,1020,860,47.2633,1560
2711,4,1.0,1210,1.5,6,1210,0,47.6872,1540
2712,4,2.5,2331,2.0,8,2331,0,47.4444,2441
2713,5,3.5,3760,2.0,10,3150,610,47.5605,3550
2714,3,3.0,2940,2.0,9,2230,710,47.6641,1580
2715,3,1.5,1110,2.0,8,940,170,47.5929,1380
2716,3,2.25,2560,1.0,9,1280,1280,47.4655,2760
2717,3,1.0,1060,1.0,6,1060,0,47.7712,2190
2718,6,4.5,2810,1.0,8,2010,800,47.4045,1940
2719,3,1.75,1380,1.0,7,930,450,47.6841,1320
2720,3,1.75,1380,1.0,7,930,450,47.6841,1320
2721,3,1.5,1790,2.0,7,1790,0,47.2309,1970
2722,3,2.5,1600,2.0,7,1600,0,47.3314,1600
2723,2,1.0,910,1.0,6,910,0,47.7153,1520
2724,3,1.5,1800,1.0,7,1800,0,47.333,1490
2725,3,2.5,1670,2.0,7,1670,0,47.4799,2560
2726,4,2.5,2800,2.0,8,2800,0,47.776,1880
2727,3,1.75,1150,1.0,5,590,560,47.6973,1150
2728,3,2.5,1790,2.0,7,1790,0,47.3841,1610
2729,2,1.0,720,1.0,6,720,0,47.551,920
2730,2,1.0,930,1.0,6,930,0,47.6567,1240
2731,3,2.5,1720,2.0,7,1720,0,47.4034,1720
2732,3,1.0,1100,1.0,7,900,200,47.6872,1170
2733,2,1.0,1280,1.0,7,1140,140,47.5258,1050
2734,3,2.5,2820,1.0,8,1410,1410,47.7609,1540
2735,2,3.25,1550,3.0,8,1550,0,47.5684,2710
2736,2,2.0,1090,2.0,7,1090,0,47.7526,1078
2737,2,2.25,1040,2.0,8,1040,0,47.6692,1264
2738,4,2.5,2310,1.5,7,1490,820,47.6889,1580
2739,3,1.5,1240,1.0,6,1240,0,47.3683,1060
2740,3,1.75,1620,1.0,7,1110,510,47.6393,2100
2741,4,2.5,1870,2.0,8,1870,0,47.4314,2020
2742,4,1.75,2040,1.0,7,1360,680,47.3107,2310
2743,3,1.75,2140,1.0,7,1070,1070,47.6993,2280
2744,5,2.5,2200,2.0,7,2200,0,47.3675,1850
2745,3,2.0,1540,1.0,6,1540,0,47.7372,1490
2746,3,2.0,1540,1.0,6,1540,0,47.7372,1490
2747,3,1.75,1370,1.0,8,1370,0,47.6982,1180
2748,3,2.5,2700,2.0,8,2700,0,47.5376,2740
2749,4,2.0,1610,1.0,7,1610,0,47.5327,1450
2750,3,1.75,1740,1.0,7,1740,0,47.7717,1810
2751,5,2.75,3280,1.0,9,2050,1230,47.5504,3060
2752,3,1.75,2020,1.0,7,1370,650,47.7487,1500
2753,3,1.5,1150,1.0,6,1150,0,47.4927,1160
2754,5,2.5,2240,1.0,7,1340,900,47.7198,1820
2755,4,2.25,2840,1.0,8,1780,1060,47.7505,2290
2756,4,2.5,2080,2.0,8,2080,0,47.2627,2580
2757,2,1.0,1550,1.0,6,1550,0,47.4315,1188
2758,4,2.0,1410,1.5,8,1410,0,47.6385,1240
2759,2,1.0,1240,1.0,7,1240,0,47.3714,1660
2760,5,4.25,4420,2.0,11,3510,910,47.5262,4220
2761,2,1.5,2060,1.0,6,1190,870,47.515,1430
2762,4,2.75,2530,1.0,8,1280,1250,47.313,2280
2763,5,3.5,2880,2.0,8,1980,900,47.4874,2120
2764,4,2.5,2820,2.0,9,2820,0,47.3415,3330
2765,3,1.0,1230,1.0,7,1230,0,47.3266,1230
2766,3,2.25,3190,2.0,9,3190,0,47.5477,3190
2767,4,1.0,1550,1.0,6,1550,0,47.6229,1210
2768,2,1.0,1240,1.5,7,1240,0,47.7326,2790
2769,3,2.75,1900,2.0,7,1900,0,47.402,1620
2770,4,2.5,2540,2.0,8,1870,670,47.4608,2290
2771,3,2.0,1700,1.0,7,1700,0,47.4164,2480
2772,4,2.75,3950,2.0,8,3950,0,47.5489,2350
2773,3,2.5,2290,3.0,9,2290,0,47.641000000000005,2260
2774,3,1.75,1200,1.0,6,1200,0,47.4236,2150
2775,3,1.75,1850,2.5,8,1850,0,47.6602,1970
2776,4,1.0,2070,1.0,7,1160,910,47.632,1730
2777,4,2.75,3280,2.0,10,3280,0,47.7073,3490
2778,7,1.5,2660,1.5,7,2660,0,47.4644,1710
2779,4,2.5,1790,1.0,8,1240,550,47.5344,1790
2780,4,2.0,1580,1.5,7,1580,0,47.5454,1580
2781,5,2.25,3470,1.5,8,2790,680,47.3342,2020
2782,2,1.0,1190,1.0,7,1190,0,47.5717,1600
2783,5,2.5,2450,2.0,8,2450,0,47.3572,1940
2784,3,2.25,2130,2.0,8,2130,0,47.6471,2130
2785,4,2.5,2560,2.0,8,1610,950,47.6885,1760
2786,3,2.0,1760,1.0,7,1760,0,47.3838,2590
2787,3,1.0,1000,1.0,6,1000,0,47.3056,1020
2788,3,2.25,2170,1.0,8,2170,0,47.4562,2080
2789,3,2.5,3080,2.0,9,3080,0,47.3726,2780
2790,4,2.25,1800,2.0,7,1800,0,47.3498,1810
2791,2,1.0,1140,1.0,7,1140,0,47.5323,1230
2792,4,2.5,2990,2.0,10,2990,0,47.5601,3250
2793,3,1.75,1930,1.0,8,1930,0,47.7692,1930
2794,3,1.0,960,1.0,5,960,0,47.497,1150
2795,3,2.25,1570,1.0,7,1180,390,47.1937,1570
2796,5,1.0,3240,2.0,9,3240,0,47.523,3240
2797,3,2.5,2130,3.0,9,2130,0,47.6389,1970
2798,3,1.75,1970,1.0,8,1420,550,47.7602,2140
2799,3,2.5,2990,2.0,9,2990,0,47.4928,2790
2800,2,1.0,1160,1.0,7,1160,0,47.7244,1440
2801,3,2.5,2170,2.0,7,2170,0,47.5403,2440
2802,3,2.25,1250,3.0,8,1250,0,47.7098,1250
2803,4,2.5,1940,1.0,8,1140,800,47.4157,1920
2804,3,1.0,950,1.0,7,950,0,47.7543,1240
2805,4,2.5,1961,2.0,7,1961,0,47.3507,1961
2806,3,1.75,1500,1.0,8,1500,0,47.6722,1920
2807,4,2.5,2440,1.0,8,1560,880,47.5614,2260
2808,3,0.75,1040,1.0,6,1040,0,47.7639,1410
2809,4,2.25,2730,2.0,8,2730,0,47.5913,2730
2810,2,1.0,920,1.0,7,920,0,47.6903,1560
2811,4,1.75,1860,1.0,8,1860,0,47.626000000000005,1860
2812,3,1.0,1380,1.0,6,1380,0,47.57,1790
2813,6,1.75,2210,1.0,7,1310,900,47.4594,1850
2814,4,2.5,2640,1.0,8,1590,1050,47.4258,2390
2815,4,2.25,2010,1.0,8,2010,0,47.5956,1930
2816,3,2.5,2080,2.0,7,2080,0,47.53,2080
2817,5,4.25,3970,2.0,9,2860,1110,47.5402,3480
2818,4,2.75,1580,1.0,7,1080,500,47.7368,1740
2819,3,1.5,990,2.0,8,840,150,47.6236,1350
2820,6,4.75,5770,2.0,12,4500,1270,47.5512,4470
2821,2,1.0,990,1.0,6,990,0,47.4145,2090
2822,2,1.0,990,1.0,6,990,0,47.4145,2090
2823,2,1.0,1480,1.0,7,1050,430,47.6842,1310
2824,2,1.0,1480,1.0,7,1050,430,47.6842,1310
2825,2,1.0,1000,1.0,7,1000,0,47.7444,1620
2826,3,1.75,1510,1.0,7,1220,290,47.6226,1950
2827,3,1.75,1750,2.0,7,1750,0,47.3264,1170
2828,5,2.5,3020,1.0,8,1650,1370,47.5897,2930
2829,3,2.5,2030,1.0,9,2030,0,47.3942,1870
2830,5,2.75,2470,1.0,8,1250,1220,47.4496,2140
2831,4,2.0,2060,1.0,7,1030,1030,47.6992,1280
2832,3,2.25,2180,1.5,8,1520,660,47.6412,1850
2833,4,1.5,2740,1.0,8,1370,1370,47.6523,2160
2834,4,3.0,2000,1.5,7,2000,0,47.6762,1670
2835,3,1.75,1620,2.0,7,1620,0,47.2875,2190
2836,4,3.0,3180,2.0,9,3180,0,47.6371,3110
2837,3,2.5,1780,2.0,7,1780,0,47.3772,1670
2838,3,1.75,1830,1.0,7,1200,630,47.5087,1830
2839,4,2.25,2510,2.0,9,2510,0,47.6153,2510
2840,4,3.25,3200,2.0,9,2390,810,47.664,1830
2841,4,4.0,5050,2.0,10,3260,1790,47.5269,3370
2842,3,2.25,1830,2.0,7,1830,0,47.2734,1670
2843,2,1.0,1010,1.0,7,1010,0,47.6846,1680
2844,3,2.5,2140,1.0,8,1290,850,47.5053,2090
2845,3,1.75,2230,1.0,8,1630,600,47.4092,1730
2846,6,1.75,2540,1.0,8,1340,1200,47.4414,1900
2847,4,1.0,3390,1.5,8,2190,1200,47.5824,2030
2848,3,2.25,1470,2.0,8,1080,390,47.6762,1640
2849,5,2.0,2130,1.5,7,1270,860,47.575,1710
2850,3,1.0,1630,1.5,8,1630,0,47.6351,1710
2851,2,1.5,1170,3.0,8,1170,0,47.6719,1290
2852,4,2.5,2750,2.0,10,2750,0,47.6595,2750
2853,4,1.75,2000,1.0,7,1010,990,47.374,1490
2854,3,1.75,2170,1.0,7,1110,1060,47.6546,1890
2855,3,1.5,1380,1.0,7,1380,0,47.3204,1600
2856,3,1.75,1560,1.0,6,780,780,47.5272,1320
2857,4,2.0,2310,1.0,7,1430,880,47.5471,1630
2858,4,3.5,2650,2.0,9,2060,590,47.6735,1470
2859,3,2.25,1760,1.0,7,1160,600,47.4501,1290
2860,4,2.75,3350,2.0,9,3350,0,47.6849,3625
2861,4,2.0,1950,1.0,7,1950,0,47.6332,1920
2862,3,1.0,1210,1.0,6,1210,0,47.7125,1260
2863,4,2.5,1690,1.5,7,1140,550,47.6825,1600
2864,3,1.5,1350,1.0,7,1350,0,47.4805,1510
2865,4,2.75,3120,2.0,9,3120,0,47.594,3200
2866,2,1.0,1050,1.0,6,780,270,47.7598,1340
2867,3,2.5,1590,2.0,7,1590,0,47.3493,1750
2868,3,1.5,1530,1.0,8,1530,0,47.7691,2150
2869,3,1.0,1470,1.0,7,1220,250,47.5276,1470
2870,3,1.0,1470,1.0,7,1220,250,47.5276,1470
2871,4,3.0,3150,2.0,9,3150,0,47.5968,3150
2872,4,2.5,2380,2.0,8,2380,0,47.3662,2170
2873,4,3.0,3600,2.0,9,3600,0,47.6257,2620
2874,4,3.0,3150,2.0,9,3150,0,47.5974,2970
2875,1,1.0,1080,1.5,7,1080,0,47.6603,1620
2876,5,4.5,4850,2.0,10,4850,0,47.3181,1640
2877,3,2.25,1780,2.0,8,1780,0,47.5495,1770
2878,2,2.5,1780,3.0,8,1350,430,47.6962,1390
2879,4,2.5,1930,1.0,7,1120,810,47.3261,1830
2880,3,1.0,2270,1.0,7,1170,1100,47.688,1860
2881,4,1.75,2250,1.0,8,2150,100,47.3789,2150
2882,4,1.75,1670,1.0,7,1070,600,47.5056,1660
2883,4,2.5,3220,1.0,10,3220,0,47.5692,4200
2884,2,1.5,790,2.0,8,700,90,47.651,1370
2885,4,3.5,3790,2.5,9,3790,0,47.6956,3370
2886,3,2.5,2370,3.0,8,2370,0,47.6148,2590
2887,4,2.5,1970,2.0,7,1970,0,47.3576,1970
2888,4,2.25,2720,1.0,8,2000,720,47.5851,2720
2889,3,2.5,1400,1.0,7,1120,280,47.3788,1530
2890,4,3.5,5844,2.0,11,5844,0,47.3293,3413
2891,4,1.75,1840,1.0,7,960,880,47.6074,1840
2892,3,2.25,2530,2.0,8,2530,0,47.3742,2480
2893,5,3.0,5530,1.5,10,5530,0,47.7352,3800
2894,4,2.25,2800,1.0,8,1680,1120,47.7448,2260
2895,2,1.0,830,1.0,6,830,0,47.7466,1340
2896,4,2.5,2060,1.0,8,1440,620,47.7272,2280
2897,4,2.25,2400,2.0,7,2400,0,47.2866,1610
2898,3,1.75,2030,1.0,8,2030,0,47.2618,2570
2899,3,1.0,880,1.0,6,880,0,47.1963,1020
2900,3,2.0,1320,1.5,7,1320,0,47.5752,1620
2901,4,2.5,2160,1.0,7,1390,770,47.7754,2190
2902,4,2.5,1780,2.0,7,1780,0,47.3828,1630
2903,3,1.0,2040,1.0,8,1680,360,47.7028,2300
2904,2,1.0,680,1.0,5,680,0,47.6901,1070
2905,5,3.25,2820,1.5,7,2320,500,47.5357,1560
2906,2,1.0,1790,1.5,8,1490,300,47.5926,1458
2907,2,1.0,840,1.0,7,840,0,47.5247,1630
2908,3,1.75,1820,1.0,8,1820,0,47.3074,2210
2909,2,1.0,1270,1.0,6,650,620,47.5351,1270
2910,4,1.75,2460,1.5,7,1620,840,47.5601,1760
2911,3,1.75,1970,1.0,8,1970,0,47.3619,1970
2912,2,2.5,2110,1.0,8,1590,520,47.4137,1960
2913,3,1.75,2390,1.0,8,1350,1040,47.7244,1710
2914,6,4.0,2280,1.0,7,1270,1010,47.5556,1760
2915,4,3.0,2530,1.5,7,1540,990,47.6287,1640
2916,3,2.0,1360,1.0,7,1360,0,47.2574,1390
2917,3,2.5,1660,2.0,7,1660,0,47.3763,1740
2918,3,2.5,1720,2.0,7,1720,0,47.4319,1720
2919,2,2.0,1290,1.0,7,950,340,47.5346,1290
2920,4,2.5,1850,2.0,7,1600,250,47.5529,1770
2921,3,1.0,2010,1.0,7,1210,800,47.5515,2460
2922,6,3.75,3810,2.0,8,3810,0,47.694,1830
2923,4,3.5,3630,2.0,10,3630,0,47.5189,1620
2924,3,2.5,2680,2.0,9,2680,0,47.7031,2840
2925,3,2.5,2100,2.0,8,2100,0,47.7508,2250
2926,4,2.25,2360,2.0,8,2360,0,47.4403,2160
2927,4,1.5,2040,1.0,7,1190,850,47.4557,1960
2928,4,2.25,3960,2.0,9,2630,1330,47.6317,3850
2929,4,2.5,2380,2.0,7,2380,0,47.3982,2310
2930,4,2.5,2170,2.0,8,2170,0,47.5057,2170
2931,4,2.5,2110,1.0,8,1270,840,47.6431,2140
2932,3,4.0,3910,2.0,10,2610,1300,47.6393,2890
2933,4,2.5,2590,2.0,8,2590,0,47.3883,2410
2934,3,1.0,1630,1.0,7,1630,0,47.7293,1480
2935,2,1.0,910,1.0,6,910,0,47.683,1480
2936,4,2.5,2600,2.0,8,2600,0,47.5971,2910
2937,2,1.0,1730,1.0,7,1380,350,47.2956,1310
2938,5,1.75,1720,1.0,8,1150,570,47.7365,1750
2939,4,2.5,3110,2.0,9,3110,0,47.701,3200
2940,2,1.0,1250,1.0,7,1250,0,47.7284,1130
2941,4,2.5,2070,2.0,8,2070,0,47.4498,1900
2942,3,1.5,1520,1.0,7,1040,480,47.2907,1440
2943,3,2.75,2780,3.0,10,2780,0,47.6569,2820
2944,2,1.0,920,1.0,7,920,0,47.5569,1190
2945,3,1.75,1170,1.0,7,1170,0,47.6849,1870
2946,4,2.5,3290,2.0,9,3290,0,47.5961,3210
2947,4,2.5,2660,2.0,9,2660,0,47.4911,3060
2948,7,4.0,3440,2.0,7,3440,0,47.6981,1420
2949,3,1.0,1730,1.0,7,1030,700,47.5024,1610
2950,3,1.75,1150,1.0,7,1150,0,47.5531,1350
2951,3,2.75,3890,2.0,8,3260,630,47.5445,2490
2952,3,1.0,1160,1.5,7,1160,0,47.5651,1340
2953,3,1.0,1440,1.5,7,1440,0,47.6898,2010
2954,4,2.0,2600,1.0,8,1400,1200,47.637,2050
2955,3,3.25,2640,1.0,8,1960,680,47.5374,3690
2956,4,1.75,1700,1.0,7,1120,580,47.4801,1560
2957,3,2.5,1960,2.0,8,1960,0,47.5315,2450
2958,3,1.75,1830,1.0,8,1230,600,47.7427,1840
2959,3,2.25,2240,1.0,8,2240,0,47.5937,2240
2960,4,3.25,2740,2.0,9,2060,680,47.5346,3030
2961,3,1.0,1480,1.0,7,970,510,47.7757,2020
2962,3,2.0,2860,1.0,9,1700,1160,47.7718,1460
2963,3,1.5,1460,1.0,7,1460,0,47.4402,1580
2964,6,3.0,3300,2.0,8,2200,1100,47.6557,1420
2965,2,1.5,1960,1.0,8,1210,750,47.6849,2060
2966,3,1.0,1170,1.0,6,1170,0,47.2109,1280
2967,3,1.75,1610,1.0,7,1050,560,47.3429,1550
2968,4,2.25,2590,2.0,8,2590,0,47.769,2670
2969,4,1.0,1340,1.0,7,1340,0,47.3313,1120
2970,3,1.75,1510,1.0,8,1510,0,47.5931,2660
2971,3,1.0,910,1.0,7,910,0,47.726000000000006,1480
2972,3,2.5,1970,2.0,7,1970,0,47.7453,1970
2973,4,2.5,1980,2.0,7,1980,0,47.3675,1610
2974,4,2.75,3150,1.0,10,2480,670,47.7302,3150
2975,4,2.5,4700,2.0,10,4700,0,47.5878,2870
2976,3,2.25,2300,1.0,8,1150,1150,47.6322,2200
2977,4,2.75,2640,2.0,7,1840,800,47.6783,1690
2978,4,2.5,3060,2.0,9,3060,0,47.5521,2930
2979,1,0.75,840,1.5,6,840,0,47.4756,1560
2980,1,0.75,840,1.5,6,840,0,47.4756,1560
2981,4,2.75,2330,1.0,7,1800,530,47.4193,1480
2982,4,1.0,1440,1.0,7,1040,400,47.571000000000005,1320
2983,3,1.75,1630,1.0,7,1100,530,47.3605,1630
2984,3,2.5,1778,2.0,7,1778,0,47.6811,2840
2985,3,2.5,1930,2.0,8,1930,0,47.5791,1770
2986,4,2.25,2460,2.0,8,2460,0,47.548,2460
2987,4,2.25,2870,1.0,8,1480,1390,47.5787,2930
2988,5,3.0,2970,2.0,9,2970,0,47.5973,2970
2989,4,3.0,2880,2.0,9,1920,960,47.6448,2110
2990,4,2.5,3110,2.0,10,3110,0,47.5623,3110
2991,3,2.5,2150,2.0,8,2150,0,47.3515,2150
2992,3,2.0,2590,1.5,7,1790,800,47.635,2440
2993,2,1.75,1240,1.5,7,1240,0,47.6689,1800
2994,4,2.5,1780,2.0,7,1780,0,47.4455,1990
2995,4,2.25,2920,2.0,9,2260,660,47.638000000000005,4510
2996,2,1.0,870,1.0,6,870,0,47.6697,1750
2997,4,2.5,2830,2.0,9,2170,660,47.6952,1880
2998,3,1.75,1520,1.0,7,1520,0,47.667,2040
2999,3,1.75,1770,2.0,7,1770,0,47.7289,1680
3000,2,1.0,980,1.0,6,980,0,47.3674,980
3001,3,2.0,1750,1.0,7,1490,260,47.5887,2450
3002,3,2.0,1610,2.0,8,1610,0,47.5969,2540
3003,5,2.75,2670,2.0,7,1800,870,47.6711,2460
3004,4,3.0,2420,2.0,7,2420,0,47.4693,2420
3005,5,4.0,4420,2.0,10,2740,1680,47.6468,3720
3006,2,1.0,1280,1.0,7,1200,80,47.6762,1860
3007,4,2.5,2520,2.0,8,2520,0,47.5399,2580
3008,4,1.0,1530,1.0,7,1130,400,47.5507,1540
3009,4,2.25,1740,1.0,8,1740,0,47.5132,1680
3010,3,1.5,1240,1.0,7,1240,0,47.4469,1670
3011,4,2.5,2740,2.0,9,2740,0,47.6095,2760
3012,3,2.5,2950,1.5,10,2950,0,47.7316,3810
3013,6,2.5,2820,1.0,8,1430,1390,47.565,2070
3014,5,3.25,3710,2.0,8,2510,1200,47.6101,1720
3015,4,2.75,2490,1.5,7,1610,880,47.6551,1420
3016,5,5.0,5000,2.0,10,5000,0,47.6012,3030
3017,1,1.0,630,1.0,5,630,0,47.6923,1390
3018,3,1.0,1070,1.0,6,1070,0,47.5015,1050
3019,2,1.75,1900,1.0,7,1200,700,47.5689,1370
3020,3,2.0,1490,2.0,6,1490,0,47.6933,1500
3021,3,1.0,2000,1.0,7,1680,320,47.711000000000006,2000
3022,3,1.5,1140,1.0,7,840,300,47.4755,1200
3023,3,1.0,1120,1.0,7,1120,0,47.7551,1120
3024,5,2.75,2500,1.0,8,2500,0,47.5938,1700
3025,1,2.0,1240,2.0,6,1240,0,47.4778,1030
3026,2,2.25,1660,2.0,7,1660,0,47.4333,1620
3027,4,1.5,1050,1.0,7,1050,0,47.4151,1390
3028,4,2.5,2660,2.0,9,2660,0,47.6972,2890
3029,3,2.5,1870,2.0,8,1870,0,47.3739,1580
3030,4,2.0,1800,1.5,7,1800,0,47.6388,1950
3031,5,3.0,2100,1.0,7,1250,850,47.4866,2100
3032,3,2.5,2170,2.0,8,2170,0,47.4819,2610
3033,4,2.75,3770,2.0,9,3070,700,47.5849,3000
3034,2,1.0,1020,1.0,7,1020,0,47.4206,1930
3035,3,1.5,1700,1.0,7,1100,600,47.3209,1700
3036,3,1.5,2020,1.0,6,1190,830,47.6641,2370
3037,4,3.75,3210,2.0,8,3210,0,47.7268,2350
3038,3,2.25,2350,1.0,7,1390,960,47.7417,2350
3039,4,2.25,2620,1.0,9,2620,0,47.6117,2370
3040,4,1.5,1220,1.0,7,1220,0,47.6205,1350
3041,4,2.5,2200,1.0,8,1500,700,47.7711,2280
3042,2,1.75,2120,1.0,6,1130,990,47.5304,1220
3043,4,2.25,1890,1.0,8,1890,0,47.6338,1920
3044,2,1.0,750,1.0,6,750,0,47.5312,930
3045,3,1.75,1630,1.0,7,1330,300,47.4514,1940
3046,5,1.5,1720,1.0,7,1720,0,47.5241,1560
3047,3,1.0,1490,1.5,7,1490,0,47.6549,2290
3048,3,1.75,1250,1.0,7,980,270,47.685,1250
3049,4,1.75,2280,1.5,7,1470,810,47.6754,1850
3050,4,2.5,2110,2.0,9,2110,0,47.6374,2180
3051,4,2.5,2520,1.0,8,1440,1080,47.6748,2360
3052,3,1.0,1590,1.0,7,1590,0,47.5355,1780
3053,4,2.75,2090,1.0,6,2090,0,47.4854,1460
3054,2,1.0,790,1.0,6,790,0,47.7634,2350
3055,2,1.0,710,1.0,6,710,0,47.5535,960
3056,2,1.0,1430,1.5,7,1300,130,47.6415,1750
3057,3,1.0,1870,1.0,8,1720,150,47.7162,1460
3058,4,2.5,2010,1.0,8,1310,700,47.553,1850
3059,4,2.5,2540,2.0,9,2540,0,47.6694,2560
3060,2,2.25,1290,2.0,7,1290,0,47.6803,1360
3061,4,1.5,1240,1.0,7,1240,0,47.3206,1240
3062,2,1.0,890,1.0,7,890,0,47.6666,1680
3063,4,2.5,2650,2.0,11,2650,0,47.5761,3270
3064,3,1.75,1750,1.0,7,1750,0,47.4989,1230
3065,3,2.75,1700,1.0,7,1060,640,47.6767,1880
3066,3,2.25,1470,1.0,7,1350,120,47.4968,1540
3067,4,2.5,3180,2.0,11,3180,0,47.5372,3130
3068,5,4.25,6510,2.0,11,3250,3260,47.5758,4480
3069,2,2.0,1440,1.5,7,1440,0,47.6902,1490
3070,3,1.0,1150,1.0,7,1150,0,47.3172,1180
3071,4,2.5,2300,1.0,8,1360,940,47.2979,1910
3072,4,1.5,3050,1.0,8,1650,1400,47.5266,2930
3073,2,1.75,1740,1.0,8,1280,460,47.6461,1820
3074,3,1.0,1170,1.0,7,1170,0,47.625,1170
3075,4,3.25,1946,2.0,7,1946,0,47.359,1460
3076,3,1.75,1740,1.0,7,1140,600,47.2968,1690
3077,4,2.5,3830,2.0,8,2900,930,47.5384,3400
3078,3,2.5,1720,2.0,7,1720,0,47.4895,1760
3079,4,2.5,2620,2.0,9,2620,0,47.6272,2260
3080,3,1.75,1850,1.0,8,1150,700,47.6871,1450
3081,3,2.0,1550,1.5,7,1550,0,47.3699,1840
3082,4,2.0,3740,2.0,9,3740,0,47.6728,3180
3083,3,2.25,1940,1.0,8,1440,500,47.3565,1880
3084,2,1.0,1470,1.0,7,770,700,47.5348,1410
3085,3,2.0,2300,1.0,8,1430,870,47.6075,2140
3086,3,1.75,1800,1.0,8,1390,410,47.5815,2210
3087,3,2.0,1190,1.5,6,1190,0,47.5276,1680
3088,4,2.5,3000,2.0,8,3000,0,47.7066,3000
3089,3,2.25,1358,3.0,7,1358,0,47.7054,1358
3090,3,2.0,1640,2.0,7,1640,0,47.6829,1070
3091,5,3.75,3870,2.0,10,3870,0,47.6078,3600
3092,4,2.25,2860,1.0,8,1460,1400,47.7655,1730
3093,4,2.5,1740,1.0,7,1740,0,47.5026,1190
3094,2,2.0,1350,1.0,8,1350,0,47.7094,1440
3095,3,1.0,1460,1.5,7,1460,0,47.6626,2280
3096,3,1.0,1864,1.0,7,1864,0,47.285,990
3097,4,1.75,1930,1.0,8,1130,800,47.6935,1850
3098,3,2.0,2020,1.5,10,1790,230,47.6388,2580
3099,4,2.25,3410,2.0,8,2410,1000,47.505,2870
3100,4,2.5,3040,2.0,10,3040,0,47.4872,2990
3101,3,2.5,2710,2.0,7,2710,0,47.3357,2720
3102,3,2.25,1190,1.0,7,1190,0,47.4813,1630
3103,3,2.5,2300,2.0,9,2300,0,47.7369,2480
3104,4,1.75,1420,2.0,7,1420,0,47.3121,1420
3105,3,1.5,1750,1.0,7,1050,700,47.6799,1750
3106,3,1.0,1020,1.0,7,880,140,47.6924,1580
3107,3,2.25,2010,2.0,8,2010,0,47.7276,2240
3108,3,3.0,1990,1.0,7,1440,550,47.3499,1670
3109,4,2.5,2790,2.0,9,2790,0,47.7674,2890
3110,4,2.0,2240,1.0,8,1340,900,47.5096,1930
3111,6,3.0,3320,1.0,8,1660,1660,47.2983,2330
3112,4,2.5,2980,2.0,10,2980,0,47.5857,3080
3113,3,2.5,1800,2.0,7,1800,0,47.7126,2106
3114,4,1.75,1850,1.0,7,1100,750,47.7481,2260
3115,4,1.75,1850,1.0,7,1100,750,47.7481,2260
3116,3,2.25,1430,2.0,8,980,450,47.5908,2210
3117,5,2.5,3280,2.0,9,3280,0,47.475,3360
3118,3,1.0,1180,1.0,7,1180,0,47.3845,1220
3119,3,2.5,1940,1.0,8,1340,600,47.7471,2080
3120,2,1.75,1300,2.0,7,1300,0,47.6687,1350
3121,3,1.5,1140,2.0,7,1140,0,47.5701,1150
3122,4,2.75,3440,2.0,10,3440,0,47.5168,2560
3123,3,1.75,1800,1.0,7,1200,600,47.4932,980
3124,4,2.25,2370,1.0,8,1440,930,47.7023,3280
3125,4,2.0,1750,1.0,7,1050,700,47.3164,1640
3126,4,1.75,1560,1.0,7,1560,0,47.7274,2080
3127,5,2.5,2820,2.0,8,2820,0,47.2616,2610
3128,3,3.0,1845,2.0,8,1845,0,47.5204,2100
3129,2,1.0,830,1.0,6,830,0,47.3813,1160
3130,2,1.0,830,1.0,6,830,0,47.3813,1160
3131,3,1.0,1510,1.0,6,860,650,47.6966,1510
3132,3,1.0,1510,1.0,6,860,650,47.6966,1510
3133,3,1.5,1600,1.5,8,1250,350,47.6122,1540
3134,4,2.5,2480,2.0,8,2480,0,47.7383,2270
3135,3,1.0,920,1.0,6,920,0,47.2892,1010
3136,3,1.0,920,1.0,6,920,0,47.2892,1010
3137,4,2.5,2320,2.0,7,2320,0,47.5415,2060
3138,4,3.0,3110,2.0,9,3110,0,47.4619,3080
3139,4,2.5,2110,2.0,8,2110,0,47.4457,2040
3140,2,1.0,750,1.0,6,750,0,47.6995,1470
3141,3,2.25,1800,1.0,8,1340,460,47.3813,2000
3142,4,2.25,2220,1.0,9,1690,530,47.7449,2110
3143,3,2.25,1840,1.0,8,1370,470,47.3144,1870
3144,4,2.5,2650,2.0,8,2650,0,47.2739,2340
3145,3,2.75,2780,1.5,8,1870,910,47.5632,1700
3146,5,2.75,2770,1.0,7,1700,1070,47.5188,1720
3147,3,1.75,2260,1.0,8,1520,740,47.5982,2530
3148,3,2.0,1460,1.0,7,1460,0,47.6644,1620
3149,3,2.25,1880,1.0,8,1420,460,47.6396,2060
3150,3,1.75,1280,1.5,7,1280,0,47.6871,980
3151,4,1.0,2200,1.0,8,1640,560,47.7473,3250
3152,2,1.0,1270,3.0,7,1270,0,47.5552,1140
3153,5,3.5,3490,2.0,8,3490,0,47.6707,3070
3154,3,1.0,1390,1.0,7,1390,0,47.6071,2290
3155,3,3.0,3030,2.0,8,1760,1270,47.4694,2810
3156,3,1.0,1650,1.0,7,1170,480,47.7695,1690
3157,2,1.0,1170,1.0,7,1170,0,47.6784,1560
3158,5,5.5,7400,2.0,13,6290,1110,47.5431,6110
3159,3,2.5,2550,1.0,8,1750,800,47.6992,2180
3160,4,1.75,2390,1.0,8,1390,1000,47.6956,2210
3161,3,1.0,1270,1.0,6,650,620,47.4961,1200
3162,4,2.0,1810,2.0,8,1700,110,47.6132,1470
3163,4,2.75,2520,2.0,9,2520,0,47.7344,2330
3164,3,1.0,1280,1.0,6,1280,0,47.3686,1060
3165,3,2.5,1590,2.0,7,1590,0,47.33,1580
3166,3,2.75,2000,1.0,7,1000,1000,47.4531,1440
3167,3,1.5,1970,1.0,7,1970,0,47.4703,2240
3168,5,1.0,1590,1.5,6,1090,500,47.5075,1370
3169,2,1.5,1010,1.0,7,1010,0,47.498000000000005,1290
3170,4,2.5,2160,2.0,7,2160,0,47.4819,2160
3171,3,2.5,2420,2.0,10,2420,0,47.5595,2500
3172,3,2.25,2180,2.0,9,2180,0,47.6215,2300
3173,3,1.0,1640,1.0,7,1040,600,47.3947,2080
3174,3,2.5,2180,1.0,8,2180,0,47.2688,2090
3175,4,2.5,2120,2.0,9,2120,0,47.5654,2140
3176,2,1.0,670,1.0,6,670,0,47.5151,710
3177,3,1.75,1480,2.0,7,1480,0,47.6966,1480
3178,5,2.75,1940,2.0,7,1940,0,47.6704,1940
3179,3,2.5,1630,2.0,7,1630,0,47.4738,1660
3180,4,2.25,2520,1.0,8,1680,840,47.3202,2300
3181,4,2.5,2120,2.0,7,2120,0,47.701,2000
3182,4,2.25,1900,1.0,7,1400,500,47.3582,1700
3183,4,2.5,3250,1.0,8,2030,1220,47.6326,2970
3184,3,2.5,2020,2.0,7,2020,0,47.4659,2170
3185,4,2.75,3540,2.0,10,3540,0,47.5945,3540
3186,4,3.0,2240,2.0,7,2240,0,47.5124,1060
3187,1,0.75,590,1.0,6,590,0,47.5181,980
3188,3,2.0,1580,1.0,7,1080,500,47.6328,1650
3189,5,1.75,1880,1.0,7,960,920,47.7182,1580
3190,3,3.0,1860,1.0,7,1040,820,47.5035,1490
3191,3,1.0,1860,1.0,8,1470,390,47.5327,1770
3192,3,1.75,1720,1.0,8,1320,400,47.44,2200
3193,2,1.0,1250,1.0,6,900,350,47.6908,1520
3194,4,1.75,2020,1.0,7,1620,400,47.577,1870
3195,4,3.25,3030,1.5,9,2700,330,47.6394,1890
3196,4,2.5,3170,2.5,10,3170,0,47.6903,3360
3197,2,1.0,1120,1.0,7,1120,0,47.6567,1620
3198,4,2.25,3490,2.0,10,2280,1210,47.6424,2540
3199,4,2.25,1970,2.0,7,1970,0,47.7223,1880
3200,3,1.0,1400,1.0,7,1400,0,47.3123,1600
3201,4,2.25,2070,1.0,8,1360,710,47.6678,2180
3202,3,1.0,1520,1.0,7,990,530,47.4164,1500
3203,3,2.0,1540,2.0,8,1540,0,47.6343,2970
3204,3,2.25,1870,3.0,8,1870,0,47.6537,1690
3205,3,1.75,1840,1.0,8,1340,500,47.474,1940
3206,2,1.0,1050,1.0,7,1050,0,47.5736,1650
3207,3,2.5,1860,2.0,7,1860,0,47.776,1870
3208,4,1.75,2350,1.0,8,2350,0,47.5392,2240
3209,2,1.0,1270,1.5,7,1270,0,47.6059,2140
3210,4,2.5,2360,1.0,8,2360,0,47.369,1730
3211,4,1.75,2240,1.5,7,2240,0,47.6294,1540
3212,3,2.5,2140,2.0,8,2140,0,47.6314,2310
3213,6,2.5,2890,1.0,8,1630,1260,47.5886,2730
3214,3,2.5,1480,2.0,8,1480,0,47.7732,1650
3215,4,2.5,1680,2.0,7,1680,0,47.494,1420
3216,4,3.0,2163,2.0,7,2163,0,47.2734,1700
3217,4,2.5,2280,2.0,7,2280,0,47.5115,2280
3218,3,2.25,2020,2.0,7,2020,0,47.4487,1460
3219,3,1.75,2040,1.0,7,1340,700,47.5923,2120
3220,3,1.75,1300,1.0,8,1300,0,47.6236,1700
3221,4,2.5,2110,1.0,7,1420,690,47.6964,1890
3222,3,2.25,1590,1.0,7,1170,420,47.4291,1590
3223,4,2.0,1590,1.0,7,990,600,47.637,2190
3224,4,2.5,3290,2.0,9,3290,0,47.5994,3240
3225,3,1.0,1120,1.0,7,1120,0,47.6712,1300
3226,4,3.75,3550,2.0,11,3550,0,47.5888,4340
3227,2,2.25,1290,3.0,8,1290,0,47.6719,1350
3228,2,2.25,1290,3.0,8,1290,0,47.6719,1350
3229,4,3.5,3290,2.0,10,2220,1070,47.355,2990
3230,4,3.0,2820,2.0,10,2820,0,47.5826,2770
3231,4,1.75,2710,1.0,9,1430,1280,47.56100000000001,2640
3232,3,1.75,2120,1.0,9,1720,400,47.7665,2240
3233,3,2.0,1460,1.0,7,1460,0,47.6771,1690
3234,4,1.5,1790,1.0,6,1790,0,47.7501,1660
3235,3,2.5,2530,2.0,9,2530,0,47.7345,2450
3236,3,2.25,3200,2.0,9,2650,550,47.638000000000005,2400
3237,3,1.0,1280,1.0,7,1280,0,47.6545,2020
3238,3,1.5,1170,1.0,7,1170,0,47.7612,2220
3239,4,2.25,2700,2.0,8,2700,0,47.2087,2420
3240,4,2.5,3670,2.0,10,3670,0,47.6211,2900
3241,5,1.0,1410,1.0,7,960,450,47.4207,1400
3242,3,1.75,1560,1.0,7,1560,0,47.4088,1550
3243,3,1.75,1920,1.0,8,1440,480,47.7606,1820
3244,5,3.5,3760,2.0,9,2820,940,47.7398,3000
3245,2,1.0,930,1.0,8,930,0,47.3822,1160
3246,3,1.75,2040,1.0,8,2040,0,47.4155,2280
3247,3,1.75,1410,1.5,7,1410,0,47.6695,1820
3248,5,2.5,1970,1.0,8,1570,400,47.7412,1970
3249,3,1.0,1230,1.0,7,1230,0,47.4657,1230
3250,3,2.5,3470,2.0,10,2560,910,47.5319,3590
3251,3,2.25,1550,2.0,7,1550,0,47.737,1740
3252,4,2.5,2070,2.0,8,2070,0,47.4915,1250
3253,4,3.0,2230,2.0,8,2230,0,47.3577,2060
3254,3,2.25,1620,2.0,7,1620,0,47.3566,1470
3255,4,1.75,1840,1.0,7,1210,630,47.2987,1620
3256,4,2.5,2860,2.0,8,2190,670,47.7735,2860
3257,3,2.0,3120,1.0,7,2150,970,47.3925,2100
3258,3,2.5,1640,2.0,7,1640,0,47.4016,1850
3259,3,2.75,1970,1.5,8,1970,0,47.5374,2140
3260,3,2.5,2610,2.0,8,2610,0,47.7614,2460
3261,4,2.0,1300,1.0,7,1300,0,47.6169,1540
3262,4,2.5,3340,1.0,8,2060,1280,47.7654,2400
3263,3,1.0,1090,1.0,6,790,300,47.5343,1050
3264,3,1.0,1390,1.5,6,1390,0,47.567,1350
3265,3,2.75,1560,1.0,7,1400,160,47.7695,2210
3266,4,2.0,1650,1.0,7,860,790,47.5008,1940
3267,2,2.75,2810,1.0,7,1510,1300,47.4869,2520
3268,4,2.5,2040,2.0,8,2040,0,47.5051,2230
3269,3,1.75,1180,1.0,7,1180,0,47.4818,1480
3270,4,4.0,4090,2.0,11,4090,0,47.7226,4290
3271,4,2.5,2760,2.0,9,2760,0,47.5845,2810
3272,4,2.5,2080,2.0,8,2080,0,47.5703,2000
3273,2,1.0,950,1.0,7,950,0,47.528,1080
3274,3,1.0,1050,1.0,7,1050,0,47.2891,1430
3275,3,1.5,1510,1.0,7,1120,390,47.6119,1700
3276,2,2.25,1370,2.0,7,1200,170,47.6399,1800
3277,4,1.75,2170,1.0,7,1270,900,47.6894,1750
3278,4,3.0,3580,2.5,10,2370,1210,47.595,2580
3279,4,4.0,4320,2.0,11,3190,1130,47.5369,4010
3280,3,2.5,2560,2.0,9,2560,0,47.7354,2820
3281,4,2.5,3220,2.0,10,3220,0,47.5326,2650
3282,4,2.25,1710,1.0,7,1040,670,47.719,1780
3283,3,3.25,1460,3.0,8,1460,0,47.6535,1400
3284,2,2.0,1540,1.0,7,960,580,47.6932,1860
3285,2,2.0,1830,1.0,7,1230,600,47.6359,2020
3286,3,1.0,1300,1.0,6,1300,0,47.524,1020
3287,3,2.5,1430,2.0,7,1430,0,47.6258,1480
3288,3,1.75,1390,1.0,7,1390,0,47.2766,1550
3289,3,1.0,1120,1.0,7,1120,0,47.7254,1820
3290,3,1.75,1470,1.0,8,1470,0,47.6687,1470
3291,5,2.75,2910,2.0,8,2910,0,47.4977,1760
3292,3,2.25,1690,1.0,7,1090,600,47.4972,1950
3293,5,2.75,2400,1.0,7,1450,950,47.4683,2400
3294,4,2.25,2060,1.0,8,1320,740,47.5478,2060
3295,4,2.5,3770,2.0,10,3770,0,47.6908,4000
3296,3,1.5,1810,1.0,7,1810,0,47.2887,1710
3297,3,3.0,2610,1.5,8,2610,0,47.4414,2810
3298,2,2.0,1600,1.0,7,1600,0,47.7344,1950
3299,4,2.75,2490,2.0,9,1490,1000,47.7206,2640
3300,2,0.75,850,1.0,6,550,300,47.5588,2500
3301,3,1.75,1180,1.0,8,1180,0,47.3531,1580
3302,3,1.0,1430,1.0,6,1430,0,47.3018,1050
3303,3,1.75,1880,1.0,8,1880,0,47.3515,2260
3304,4,2.5,1580,2.0,7,1580,0,47.3768,1590
3305,4,1.75,1440,1.5,8,1290,150,47.6846,1640
3306,4,1.0,1150,1.5,7,1150,0,47.6368,1890
3307,4,2.25,2210,1.0,8,1630,580,47.4774,2340
3308,3,2.5,1440,2.0,7,1440,0,47.6818,1560
3309,3,1.5,1180,1.0,7,800,380,47.6337,1280
3310,3,1.5,1550,2.0,7,1550,0,47.7072,1820
3311,3,2.0,1700,1.0,7,1700,0,47.2077,1350
3312,5,2.0,2120,1.0,6,1080,1040,47.5979,1690
3313,4,3.5,5440,2.0,12,5440,0,47.6605,4830
3314,5,1.5,2420,1.0,8,1500,920,47.208,1620
3315,4,2.5,2170,2.0,8,2170,0,47.7346,2240
3316,3,2.5,1690,2.0,7,1690,0,47.6768,1690
3317,4,1.0,1600,1.5,7,1600,0,47.6804,1720
3318,3,1.75,1830,1.0,7,1150,680,47.5511,3380
3319,3,2.5,1690,2.0,7,1690,0,47.6802,1690
3320,2,2.25,1700,2.0,8,1700,0,47.547,1700
3321,2,1.0,850,1.0,7,850,0,47.731,1440
3322,4,2.5,2480,1.0,9,1820,660,47.6344,2910
3323,3,2.5,1690,2.0,7,1690,0,47.6875,1690
3324,2,1.75,1360,1.0,6,1360,0,47.7421,1430
3325,8,2.75,4040,1.0,9,2020,2020,47.63399999999999,3670
3326,3,1.75,1160,1.0,6,580,580,47.503,1730
3327,4,2.75,3100,2.0,8,2000,1100,47.6158,2130
3328,3,2.0,1670,1.0,8,1670,0,47.4873,2130
3329,4,2.0,5461,1.0,9,3265,2196,47.3557,1940
3330,4,3.25,4400,2.0,11,4400,0,47.5868,4440
3331,3,1.75,1470,1.0,7,1470,0,47.4192,1770
3332,3,1.75,1650,1.5,8,1650,0,47.6743,1630
3333,3,2.5,1870,2.0,8,1870,0,47.2925,2150
3334,3,2.0,2570,1.0,9,1970,600,47.7318,3070
3335,3,2.5,2260,2.0,10,2260,0,47.641000000000005,2740
3336,4,1.75,2500,1.0,8,1500,1000,47.5345,3750
3337,4,1.0,1190,1.0,6,890,300,47.5305,1140
3338,3,1.0,1230,1.5,7,1230,0,47.5616,1230
3339,3,2.5,2940,2.0,10,2940,0,47.5418,3090
3340,3,1.0,1010,1.0,7,1010,0,47.5483,1400
3341,6,2.25,2550,2.0,7,2550,0,47.6785,1480
3342,2,2.0,1350,1.0,8,1350,0,47.7192,1440
3343,4,1.75,1820,1.5,7,1120,700,47.3743,1810
3344,3,2.0,1470,1.0,6,1470,0,47.3734,1470
3345,4,1.75,2350,1.0,7,1250,1100,47.4816,2180
3346,4,2.0,1870,1.0,8,1870,0,47.4619,2270
3347,4,2.5,2790,2.0,9,2790,0,47.5349,2990
3348,4,2.25,2340,1.0,8,1700,640,47.6202,1890
3349,4,1.0,1710,1.5,6,1710,0,47.4497,1940
3350,3,1.0,1200,1.0,7,1200,0,47.6075,1800
3351,3,1.5,1310,2.0,7,1310,0,47.5879,1310
3352,4,2.5,2260,2.0,8,2260,0,47.3642,2260
3353,3,2.0,2250,1.0,9,2250,0,47.7077,2880
3354,4,1.75,1780,1.0,9,1780,0,47.6273,2100
3355,3,2.5,2120,2.0,7,2120,0,47.6811,2370
3356,2,1.0,1500,1.0,7,1190,310,47.7186,1420
3357,2,1.0,1500,1.0,7,1190,310,47.7186,1420
3358,3,1.75,2920,1.0,8,1620,1300,47.5491,2890
3359,3,1.75,1730,1.0,8,1220,510,47.6478,2020
3360,5,2.5,3100,2.0,8,3100,0,47.738,2840
3361,4,2.5,2060,2.0,7,1560,500,47.764,1760
3362,4,2.5,1620,2.0,7,1620,0,47.3661,1580
3363,4,3.0,2040,1.0,8,1490,550,47.3266,2020
3364,3,1.5,1060,1.0,7,1060,0,47.3229,1440
3365,4,3.0,1940,1.0,7,1940,0,47.7381,1310
3366,3,1.0,930,1.0,6,820,110,47.4802,1220
3367,4,2.0,2280,1.0,7,1140,1140,47.4067,2580
3368,4,1.75,2430,1.0,8,1780,650,47.7687,2340
3369,3,2.0,1320,1.0,7,1320,0,47.3947,1540
3370,3,2.5,2000,1.0,8,1040,960,47.5639,2030
3371,6,1.75,1840,1.0,7,1060,780,47.6041,1680
3372,4,2.75,2400,1.0,7,1320,1080,47.3616,2470
3373,4,1.75,2520,1.0,7,1640,880,47.6317,2110
3374,3,2.5,1570,1.0,7,1090,480,47.3327,1570
3375,3,1.75,1650,2.0,8,1300,350,47.7733,1760
3376,4,2.5,2410,2.0,8,2410,0,47.6329,2350
3377,3,2.25,1720,1.5,7,1450,270,47.6683,1410
3378,4,2.5,2680,1.0,8,1340,1340,47.5219,2180
3379,5,1.75,2640,1.0,8,1400,1240,47.5022,2400
3380,3,3.25,3730,2.0,9,3730,0,47.7246,3730
3381,3,2.0,1700,1.0,7,1700,0,47.3781,1700
3382,6,4.5,3500,2.0,7,3500,0,47.7349,1550
3383,3,2.5,2010,2.0,7,2010,0,47.5069,2010
3384,3,1.75,2130,1.0,8,1430,700,47.5326,2130
3385,4,2.5,2100,2.0,7,1400,700,47.6634,2060
3386,3,2.0,1450,1.0,7,1450,0,47.3637,2050
3387,3,2.5,1810,1.0,7,1070,740,47.7364,1740
3388,3,2.75,2090,1.0,8,1340,750,47.2741,2150
3389,3,2.75,2090,1.0,8,1340,750,47.2741,2150
3390,3,1.75,2310,1.0,8,1410,900,47.3743,2080
3391,3,2.0,1310,1.0,7,1310,0,47.3597,1530
3392,4,2.5,2040,2.0,8,2040,0,47.6458,2410
3393,4,2.5,2040,2.0,8,2040,0,47.6458,2410
3394,3,1.0,1400,1.5,7,1400,0,47.681,1400
3395,3,1.75,1790,1.0,7,1790,0,47.7442,1560
3396,3,2.5,2620,2.0,8,2620,0,47.4583,3190
3397,5,3.25,3240,1.5,9,2500,740,47.6792,2740
3398,4,1.75,2520,1.0,7,1260,1260,47.4835,2360
3399,3,2.0,1410,1.0,7,1410,0,47.427,1410
3400,4,3.5,4380,1.5,11,4380,0,47.7279,4010
3401,2,1.0,720,1.0,6,720,0,47.5535,980
3402,2,1.0,1200,1.0,6,600,600,47.5357,1270
3403,3,2.5,2620,1.0,10,2620,0,47.7238,2950
3404,3,2.25,1830,1.0,7,1460,370,47.7286,2330
3405,3,2.5,2000,1.0,8,1360,640,47.3724,2530
3406,2,1.0,980,1.0,6,980,0,47.6366,1690
3407,4,2.5,2620,2.0,7,2620,0,47.3663,2250
3408,3,2.25,1500,1.0,7,1500,0,47.4597,1750
3409,4,1.75,1630,1.0,7,1160,470,47.5674,1640
3410,3,2.0,1540,1.0,7,1540,0,47.721,2060
3411,3,1.0,1190,1.0,7,1190,0,47.3248,1200
3412,4,3.0,2370,1.0,7,1380,990,47.7258,2100
3413,4,2.5,3700,2.0,11,3700,0,47.5427,3580
3414,3,1.75,1670,1.0,8,1670,0,47.5754,1900
3415,3,2.25,1640,1.0,8,1180,460,47.3733,1600
3416,4,1.75,3550,2.0,9,3550,0,47.6236,3000
3417,1,1.0,720,1.0,7,720,0,47.6928,1580
3418,5,4.5,4400,2.0,11,3390,1010,47.6232,2150
3419,2,2.5,1420,2.0,7,1420,0,47.4871,1500
3420,3,2.25,1540,1.0,7,770,770,47.6942,1680
3421,3,2.25,1540,1.0,7,770,770,47.6942,1680
3422,4,1.75,1650,1.0,8,1650,0,47.5688,1850
3423,2,1.0,770,1.0,6,770,0,47.7534,1500
3424,4,1.75,2010,1.5,7,2010,0,47.6337,2010
3425,3,1.0,1200,1.0,7,1200,0,47.7367,1330
3426,3,1.0,1560,1.0,7,1560,0,47.4549,1468
3427,3,1.0,1030,1.0,6,880,150,47.5255,1030
3428,2,1.75,2060,1.0,7,1030,1030,47.6856,1390
3429,2,1.5,1078,2.0,7,1078,0,47.7532,1078
3430,2,1.0,890,1.0,7,890,0,47.7118,900
3431,3,1.75,1420,1.0,7,1420,0,47.6112,2020
3432,2,2.5,1860,2.0,7,1860,0,47.3847,1860
3433,2,1.0,840,1.0,7,840,0,47.684,1310
3434,4,2.5,2210,1.5,8,1480,730,47.5719,1740
3435,3,2.0,1860,2.0,8,1860,0,47.5706,1950
3436,3,2.0,1940,1.0,7,1090,850,47.6659,1700
3437,3,1.75,1170,1.0,7,1170,0,47.3679,1180
3438,3,3.25,3130,2.0,8,2190,940,47.3078,2350
3439,4,3.5,3740,2.0,11,3740,0,47.7375,3750
3440,4,1.75,2180,1.5,6,1270,910,47.5487,1400
3441,3,2.5,1780,2.0,7,1780,0,47.7346,1571
3442,4,2.5,1670,1.0,7,1170,500,47.4884,1360
3443,3,3.5,3620,2.0,10,2920,700,47.5646,3680
3444,4,2.5,4060,2.0,9,2790,1270,47.3694,2810
3445,6,3.5,2120,2.0,7,2120,0,47.4788,1860
3446,4,2.5,2410,2.0,8,2410,0,47.2641,2380
3447,3,2.25,1810,1.0,8,1450,360,47.6258,1740
3448,3,0.75,1420,1.0,7,860,560,47.6872,1350
3449,4,2.0,1560,2.0,6,1560,0,47.4927,1480
3450,3,2.0,1880,1.0,6,940,940,47.5091,2060
3451,3,2.5,2320,2.0,8,2320,0,47.591,2320
3452,3,1.75,1010,1.0,7,1010,0,47.7317,1250
3453,3,1.75,1560,1.0,8,1560,0,47.5966,2430
3454,3,3.5,1820,2.0,8,1430,390,47.596,1550
3455,4,3.25,4110,2.0,12,2720,1390,47.6934,2640
3456,3,1.0,850,1.0,6,850,0,47.7441,1150
3457,3,2.5,1740,3.0,8,1740,0,47.5892,1740
3458,4,2.5,2140,2.0,8,2140,0,47.7173,1690
3459,3,2.5,2070,2.0,8,2070,0,47.5295,2620
3460,3,2.5,1680,2.0,7,1680,0,47.6964,1710
3461,2,1.0,1000,1.0,7,1000,0,47.6753,1830
3462,4,2.25,2430,1.0,9,2430,0,47.7642,2750
3463,3,2.5,3380,2.0,10,3380,0,47.5275,3630
3464,3,2.25,1830,2.0,8,1830,0,47.2642,2160
3465,2,1.5,1240,2.0,8,1200,40,47.6104,1410
3466,4,2.0,1890,2.0,7,1890,0,47.3846,1690
3467,3,1.75,1480,1.0,7,1480,0,47.2977,1830
3468,3,1.75,1480,1.0,7,1480,0,47.2977,1830
3469,2,1.0,1120,1.0,7,1120,0,47.5397,1880
3470,3,1.75,1520,1.0,8,1520,0,47.7687,2080
3471,5,1.75,1830,1.0,7,1060,770,47.5208,1410
3472,4,3.5,2640,2.0,8,2640,0,47.5421,1700
3473,3,2.0,1550,1.0,8,1550,0,47.4654,1860
3474,3,1.75,1260,1.0,7,1260,0,47.5727,1320
3475,3,1.75,1590,1.0,7,1090,500,47.3621,1540
3476,3,2.5,1750,1.0,7,1330,420,47.352,1670
3477,4,2.25,3530,2.0,8,2860,670,47.6618,2840
3478,4,2.25,2360,1.0,9,2360,0,47.6307,2650
3479,2,2.75,2700,1.0,9,2700,0,47.7187,1440
3480,5,2.25,3270,2.0,9,2470,800,47.5428,3690
3481,2,2.0,1650,1.0,6,1650,0,47.5073,1260
3482,3,2.5,2630,2.0,8,2630,0,47.5322,2220
3483,4,2.5,2520,2.0,8,1670,850,47.6434,2290
3484,2,1.5,1520,1.0,7,1520,0,47.7131,1440
3485,4,2.0,2290,1.5,7,2290,0,47.4678,2140
3486,3,2.0,1979,1.0,7,1329,650,47.3912,1650
3487,4,3.5,2170,2.0,9,2170,0,47.6828,1950
3488,3,1.0,1210,1.0,7,1210,0,47.5377,1530
3489,4,2.5,1970,2.0,7,1440,530,47.5949,1760
3490,2,1.0,1040,1.0,7,1040,0,47.2791,1300
3491,2,1.5,1020,3.0,7,1020,0,47.6774,1138
3492,3,2.25,1670,1.0,7,1220,450,47.6028,1710
3493,5,4.5,3810,2.0,10,3810,0,47.5915,3390
3494,3,2.75,2290,2.0,9,1950,340,47.6811,2290
3495,2,1.75,590,1.0,5,590,0,47.545,1360
3496,3,2.5,1610,2.0,7,1610,0,47.3658,1680
3497,2,1.75,1400,1.0,7,710,690,47.5628,1250
3498,2,1.0,1020,1.0,7,1020,0,47.6781,1480
3499,3,2.75,1620,1.0,7,1140,480,47.6175,1900
3500,3,3.25,4560,1.0,11,2760,1800,47.6205,4060
3501,3,1.0,1150,1.0,6,1010,140,47.5194,1340
3502,3,1.75,2020,1.0,8,2020,0,47.574,2370
3503,4,2.25,1930,1.0,7,1430,500,47.4098,1714
3504,5,1.75,2500,1.0,9,1560,940,47.5361,3370
3505,3,1.5,1460,1.0,7,980,480,47.6962,2180
3506,3,2.0,1310,1.0,7,1310,0,47.3893,1100
3507,4,2.0,2920,1.0,8,1520,1400,47.5876,2360
3508,3,1.5,1150,1.0,7,1150,0,47.4752,1220
3509,3,2.75,2220,2.0,7,2220,0,47.5515,960
3510,3,1.75,1920,1.0,7,1920,0,47.4544,1560
3511,3,1.75,1410,1.0,7,1410,0,47.6931,1770
3512,5,1.5,1550,1.0,7,1550,0,47.6811,1970
3513,4,3.5,5000,2.0,11,3610,1390,47.554,3850
3514,3,1.75,2010,1.0,8,1500,510,47.373000000000005,1200
3515,4,2.5,2600,2.0,8,2600,0,47.3451,2610
3516,3,2.5,1960,2.0,8,1960,0,47.6319,2480
3517,3,1.5,1320,2.0,7,1320,0,47.5909,1320
3518,4,3.25,3090,2.0,9,3090,0,47.768,2020
3519,5,3.25,3350,2.0,8,2510,840,47.6645,1620
3520,3,2.5,1880,1.0,8,1250,630,47.5401,2030
3521,3,1.5,2600,1.0,7,1400,1200,47.5659,1320
3522,2,1.0,830,1.0,7,830,0,47.68899999999999,1460
3523,4,2.5,1975,2.0,7,1975,0,47.363,1975
3524,4,2.25,2880,1.0,8,1920,960,47.7584,2410
3525,2,1.0,1280,1.0,7,850,430,47.63399999999999,1280
3526,4,2.0,1640,1.0,6,820,820,47.4791,1640
3527,3,2.0,1470,1.0,7,1470,0,47.3539,1580
3528,3,1.0,900,1.0,6,900,0,47.2883,1460
3529,3,1.75,1510,1.0,8,1230,280,47.6387,1300
3530,6,2.75,3610,1.0,9,2070,1540,47.5739,2890
3531,3,2.0,1250,3.0,7,1250,0,47.6705,1320
3532,3,2.5,3510,2.0,9,3510,0,47.5635,3510
3533,3,1.5,1430,1.0,7,820,610,47.2927,1430
3534,2,1.0,1420,1.0,7,1420,0,47.4594,1220
3535,3,2.5,2080,2.0,8,2080,0,47.5723,2210
3536,2,2.5,1370,2.0,7,1370,0,47.4606,1370
3537,4,2.25,1900,1.0,8,1280,620,47.56100000000001,2330
3538,1,0.75,1040,1.0,7,580,460,47.5078,1560
3539,3,2.0,1990,1.0,7,1990,0,47.5421,2120
3540,3,1.0,1200,1.0,7,1200,0,47.7452,1960
3541,4,1.0,1250,1.0,7,1250,0,47.4258,1260
3542,4,2.75,2640,2.0,10,2640,0,47.6481,2980
3543,3,1.75,1730,1.0,7,1130,600,47.3915,1950
3544,4,1.5,1100,1.0,7,1100,0,47.5704,1380
3545,5,3.5,5000,2.0,10,3410,1590,47.5665,3360
3546,1,0.5,880,1.0,6,500,380,47.5732,1410
3547,3,2.5,1470,2.0,7,1470,0,47.7651,1360
3548,3,1.0,980,1.0,7,980,0,47.4892,1430
3549,4,1.0,2180,1.5,7,2180,0,47.7522,1360
3550,5,3.75,4130,2.0,9,3170,960,47.715,4130
3551,4,1.75,1850,1.5,7,1850,0,47.3468,1750
3552,3,2.5,1600,2.0,7,1600,0,47.3904,1410
3553,4,2.5,3180,2.0,7,3180,0,47.4905,2610
3554,4,3.25,2980,2.0,10,2140,840,47.5933,2200
3555,4,2.5,2440,2.0,8,2440,0,47.5108,2260
3556,3,2.25,1640,2.0,7,1640,0,47.31100000000001,1230
3557,3,2.25,2380,1.0,8,2040,340,47.6955,1680
3558,2,2.25,2460,1.5,9,1930,530,47.6792,2260
3559,4,2.0,1900,1.0,6,950,950,47.6767,1230
3560,3,1.75,1980,1.0,7,1980,0,47.3745,1630
3561,5,3.25,3970,2.0,9,2970,1000,47.7764,2520
3562,4,2.5,4570,2.0,12,4570,0,47.7282,3810
3563,3,1.75,1320,1.5,7,1320,0,47.5695,1160
3564,3,1.75,1990,2.0,9,1990,0,47.7439,2880
3565,4,1.0,2500,1.5,7,2500,0,47.6488,2880
3566,3,2.0,1440,1.0,7,1440,0,47.7243,1800
3567,6,4.5,2750,2.0,8,1770,980,47.6883,1860
3568,3,1.75,1790,1.0,8,1790,0,47.5412,1310
3569,2,2.0,1050,2.0,8,720,330,47.6181,1340
3570,3,1.0,1320,1.0,7,1320,0,47.312,1320
3571,3,1.0,1070,1.0,7,950,120,47.5627,1090
3572,4,2.5,1990,2.0,8,1990,0,47.3585,1850
3573,2,1.0,810,1.0,6,810,0,47.4882,1090
3574,3,1.5,1550,1.0,7,1550,0,47.394,1550
3575,6,2.25,2950,1.0,7,1700,1250,47.7476,1790
3576,3,1.75,1780,1.0,7,990,790,47.5696,1780
3577,3,2.5,2850,1.0,8,1680,1170,47.748000000000005,2670
3578,3,1.0,1090,1.0,6,1090,0,47.7562,1060
3579,4,2.25,1820,1.0,8,1340,480,47.7415,1270
3580,3,1.5,1320,1.0,7,1320,0,47.7126,1380
3581,4,2.0,1440,1.0,5,1440,0,47.5072,1500
3582,3,1.5,1140,1.0,6,1140,0,47.3684,980
3583,3,1.5,1120,1.0,7,1120,0,47.3632,1260
3584,4,3.25,3440,2.0,11,3440,0,47.5429,3580
3585,4,2.5,1800,1.0,7,1080,720,47.5303,1870
3586,3,2.0,1410,1.0,8,1410,0,47.5718,2690
3587,3,1.0,660,1.0,5,660,0,47.4842,1320
3588,3,1.0,1040,1.0,7,1040,0,47.5765,1280
3589,2,1.0,880,1.0,6,880,0,47.5331,1430
3590,5,2.0,2080,1.0,6,1040,1040,47.5858,1940
3591,3,2.25,1620,1.0,7,1620,0,47.4437,1910
3592,4,1.0,1680,1.5,7,1680,0,47.6663,1710
3593,3,1.75,1730,1.0,7,970,760,47.6662,1640
3594,4,2.5,1980,2.0,7,1980,0,47.3495,1980
3595,3,1.75,1340,1.0,7,1340,0,47.694,1550
3596,4,3.5,5490,1.0,12,2910,2580,47.5511,4290
3597,4,1.75,2670,2.0,8,2670,0,47.2585,2190
3598,4,2.5,1930,2.0,8,1930,0,47.4016,2280
3599,4,3.0,2100,2.0,8,2100,0,47.6807,1320
3600,4,1.75,3140,1.0,7,2320,820,47.6941,2240
3601,3,2.0,2320,1.0,7,1160,1160,47.5141,1380
3602,4,3.25,3820,2.0,10,3820,0,47.5837,2440
3603,3,3.5,2050,2.0,9,1750,300,47.4536,2300
3604,4,2.25,1680,2.0,8,1680,0,47.3258,1678
3605,4,2.5,2350,1.5,8,1690,660,47.6605,1750
3606,3,2.25,1830,1.0,7,1400,430,47.3925,1960
3607,3,2.5,1910,2.0,8,1910,0,47.5752,1800
3608,4,1.5,1980,1.5,8,1780,200,47.584,2250
3609,3,2.5,1730,2.0,7,1730,0,47.432,1780
3610,3,1.75,2030,1.0,7,2030,0,47.451,1950
3611,3,1.5,1340,1.0,7,1340,0,47.74100000000001,1540
3612,3,1.0,1130,1.0,6,1130,0,47.7359,1180
3613,2,1.0,710,2.0,7,710,0,47.6412,1370
3614,4,2.5,1788,2.0,7,1788,0,47.2883,1700
3615,3,1.75,2300,1.0,8,1520,780,47.6884,2300
3616,3,1.5,1670,1.0,7,1370,300,47.4283,1090
3617,2,1.0,1120,1.0,7,900,220,47.6924,1500
3618,5,2.75,3847,1.0,9,2299,1548,47.3379,2690
3619,3,3.5,3240,2.0,10,2130,1110,47.3388,3180
3620,4,2.5,2550,2.0,7,2550,0,47.4793,2560
3621,4,2.5,2320,2.0,8,2320,0,47.4798,2330
3622,3,2.5,2370,2.0,9,2370,0,47.5427,2660
3623,4,1.0,1350,1.5,8,1350,0,47.6885,1520
3624,2,2.0,2370,1.5,7,1600,770,47.5007,2370
3625,2,1.0,1170,1.0,6,1170,0,47.497,1820
3626,3,1.0,1092,1.5,6,1092,0,47.5321,930
3627,4,1.5,2220,1.5,8,1970,250,47.6564,1984
3628,3,2.5,2870,2.0,10,2870,0,47.6944,2840
3629,4,2.75,3950,1.0,10,2050,1900,47.6969,3130
3630,4,2.5,3160,1.0,10,3160,0,47.6418,3900
3631,3,1.0,960,1.0,7,960,0,47.238,1930
3632,2,1.5,1540,2.0,7,1540,0,47.7189,1470
3633,3,1.75,1670,1.0,7,1170,500,47.2975,1740
3634,4,2.0,2100,1.0,7,1060,1040,47.6699,1920
3635,2,1.0,1010,1.0,6,1010,0,47.5532,1560
3636,4,3.0,2500,2.0,9,2500,0,47.3325,2700
3637,4,1.5,2030,1.5,8,1530,500,47.5855,2610
3638,5,3.75,4590,2.0,11,3450,1140,47.6389,3870
3639,3,1.75,1490,1.0,8,1490,0,47.5919,2070
3640,4,1.75,2120,1.5,8,1920,200,47.6601,2300
3641,3,2.25,1830,2.0,8,1830,0,47.7466,2100
3642,4,1.5,2500,1.0,7,1250,1250,47.5212,1640
3643,2,1.0,940,1.0,6,940,0,47.7067,1290
3644,4,3.0,4370,2.0,10,4370,0,47.6573,2430
3645,3,1.75,1500,1.0,7,1500,0,47.3141,1490
3646,3,1.75,1430,1.0,6,1430,0,47.5388,1550
3647,2,1.0,900,1.0,6,760,140,47.5148,1500
3648,4,1.75,1250,1.0,6,1250,0,47.62,990
3649,4,3.5,3950,2.0,10,3950,0,47.5414,3920
3650,3,2.5,2370,2.0,7,2370,0,47.5288,2690
3651,3,1.75,1600,2.0,7,1600,0,47.6447,1660
3652,3,2.25,1322,2.0,8,1087,235,47.5976,1690
3653,3,1.75,1140,1.0,7,1140,0,47.2598,1280
3654,4,2.5,3080,2.5,8,3080,0,47.7066,2750
3655,4,1.0,1450,1.5,6,1450,0,47.7061,1450
3656,3,1.0,1440,1.0,7,790,650,47.591,2690
3657,4,2.5,3470,2.0,10,3470,0,47.554,4370
3658,3,1.0,1200,1.0,7,1200,0,47.6981,1580
3659,4,2.0,3210,1.5,7,2040,1170,47.5322,2540
3660,3,1.75,2090,1.0,8,1230,860,47.7149,2310
3661,4,2.5,1904,2.0,7,1904,0,47.3107,1560
3662,3,1.75,1320,1.0,7,1320,0,47.4557,1320
3663,3,1.75,2620,1.0,7,1330,1290,47.7235,1530
3664,4,2.75,2960,2.0,9,2210,750,47.5747,2270
3665,3,0.75,1330,1.0,7,1330,0,47.5377,1410
3666,3,1.75,1760,1.5,7,1760,0,47.6748,1760
3667,4,2.25,2420,1.0,8,1890,530,47.6287,1740
3668,3,1.0,1010,1.0,6,1010,0,47.5746,960
3669,4,2.5,1770,1.5,6,1770,0,47.719,1460
3670,4,1.75,1670,1.0,8,1670,0,47.6315,2360
3671,4,1.75,1670,1.0,8,1670,0,47.6315,2360
3672,4,2.0,1970,1.0,8,1030,940,47.6873,1650
3673,3,2.25,1740,1.0,8,1180,560,47.5339,1880
3674,3,1.75,1930,1.5,6,1930,0,47.5263,1350
3675,5,2.75,2530,1.0,7,1530,1000,47.3738,2250
3676,4,2.25,1500,2.0,7,1500,0,47.3378,1700
3677,2,1.5,1160,2.0,7,1160,0,47.7255,1410
3678,2,1.0,1300,1.0,6,1300,0,47.466,1880
3679,3,2.5,2340,2.0,8,2340,0,47.7347,2340
3680,3,1.75,1300,1.0,7,1300,0,47.7005,1370
3681,3,2.5,2240,2.0,8,2240,0,47.3503,2240
3682,3,1.5,1420,1.0,7,1420,0,47.694,1540
3683,2,1.75,1830,1.0,7,1070,760,47.5592,1570
3684,3,1.75,2180,1.0,8,1480,700,47.7594,2180
3685,6,2.0,2320,2.0,8,2320,0,47.398,2540
3686,3,1.0,840,1.0,6,840,0,47.496,1260
3687,3,1.0,840,1.0,6,840,0,47.496,1260
3688,3,1.0,1380,1.0,7,1380,0,47.4653,1040
3689,4,2.5,2110,1.0,7,1530,580,47.6882,1420
3690,3,1.75,2300,1.0,7,1350,950,47.7716,2320
3691,3,2.5,2030,2.0,8,1720,310,47.5305,1670
3692,4,1.75,2160,1.0,8,1260,900,47.6893,1670
3693,3,2.0,1650,2.0,7,1650,0,47.5713,1280
3694,4,3.75,2400,1.0,7,1370,1030,47.6295,2230
3695,3,1.0,1780,1.5,6,1050,730,47.5119,1260
3696,4,1.5,1280,1.0,7,1280,0,47.6023,1310
3697,5,2.25,2560,1.0,8,1870,690,47.5819,2070
3698,3,2.0,2270,1.0,6,1270,1000,47.5092,2210
3699,3,2.5,2080,1.0,8,1360,720,47.4694,1790
3700,2,1.0,1630,1.0,7,1630,0,47.7222,1800
3701,4,2.75,2930,1.0,8,1660,1270,47.5841,2200
3702,3,2.5,2080,2.0,8,2080,0,47.7455,2320
3703,3,2.25,2680,1.0,9,2680,0,47.4828,2680
3704,3,1.75,2040,1.5,8,1540,500,47.6608,1620
3705,4,1.75,1920,1.0,7,1920,0,47.4222,1490
3706,4,3.75,3450,2.0,10,2640,810,47.6134,3180
3707,3,1.75,2220,1.0,8,2040,180,47.774,2540
3708,4,2.5,3030,2.0,9,3030,0,47.6075,2790
3709,4,3.0,2260,2.0,7,2260,0,47.7297,2200
3710,3,2.5,2670,2.0,9,2670,0,47.6599,2670
3711,3,2.5,1520,2.0,7,1520,0,47.3687,1670
3712,3,1.75,1130,1.0,7,930,200,47.6379,1360
3713,5,2.0,3540,2.0,9,3540,0,47.7108,2280
3714,3,1.75,1680,1.5,7,1680,0,47.5745,1460
3715,1,2.0,1150,1.0,7,1150,0,47.2951,1200
3716,1,2.0,1150,1.0,7,1150,0,47.2951,1200
3717,4,2.5,3240,2.0,9,3240,0,47.5641,4610
3718,4,2.5,3480,1.5,11,3480,0,47.6404,3960
3719,3,1.0,1700,1.5,6,1200,500,47.6819,1550
3720,4,3.5,3720,2.0,10,2880,840,47.5885,2080
3721,4,2.5,3020,2.0,7,3020,0,47.5346,2640
3722,2,1.5,880,2.0,7,880,0,47.5188,1070
3723,5,3.25,3840,3.0,10,2750,1090,47.5929,2060
3724,3,2.5,1590,2.0,7,1590,0,47.4832,2160
3725,4,4.75,3700,1.0,7,1840,1860,47.768,1720
3726,4,2.5,3670,2.0,10,3670,0,47.4617,3300
3727,3,1.0,1630,1.0,7,1630,0,47.7548,1480
3728,3,3.0,4230,2.0,9,3780,450,47.4176,2880
3729,3,2.25,2110,2.0,8,2110,0,47.7311,1740
3730,3,2.0,1610,1.0,7,1110,500,47.334,1920
3731,3,2.0,1350,1.0,7,1350,0,47.7313,1350
3732,3,3.25,3130,1.0,9,2210,920,47.7741,2710
3733,4,2.5,3470,2.0,10,3470,0,47.547,3360
3734,3,1.5,1310,1.0,7,1310,0,47.7291,1090
3735,4,2.5,2460,2.0,8,2460,0,47.4912,2510
3736,4,2.5,3500,2.0,9,3500,0,47.5428,3180
3737,4,2.75,2910,1.0,9,2120,790,47.3397,2850
3738,4,1.75,1940,1.0,8,970,970,47.7578,1940
3739,3,1.0,1260,1.0,7,1260,0,47.5058,2020
3740,5,2.0,2270,1.0,7,1150,1120,47.6692,1950
3741,3,2.25,1950,2.0,8,1950,0,47.7213,1900
3742,4,2.5,3240,2.0,9,3240,0,47.5825,2920
3743,3,2.0,2440,1.0,8,1440,1000,47.375,2400
3744,4,3.25,2810,1.0,8,1680,1130,47.692,2110
3745,2,1.75,1210,1.0,7,1210,0,47.3438,1650
3746,4,4.5,3850,2.0,10,3000,850,47.5522,3480
3747,2,1.0,860,1.0,7,860,0,47.7132,1780
3748,3,1.75,2680,1.0,8,1590,1090,47.5316,2620
3749,5,1.5,1980,1.5,7,1980,0,47.4571,1510
3750,4,3.0,4500,2.0,9,3040,1460,47.5581,3540
3751,4,2.5,3220,2.0,8,2610,610,47.495,2500
3752,2,1.5,1140,2.0,7,940,200,47.6124,1460
3753,4,3.25,4360,1.0,10,3360,1000,47.6398,3540
3754,2,2.5,1310,2.0,8,1310,0,47.4911,1310
3755,3,1.0,980,1.0,6,830,150,47.5206,1140
3756,4,2.5,1820,2.0,8,1820,0,47.5842,2710
3757,5,2.5,2550,1.0,9,1610,940,47.6336,2510
3758,4,2.5,2370,2.0,9,2080,290,47.7064,2970
3759,3,1.0,1200,1.0,6,1200,0,47.3231,1250
3760,2,1.0,1140,1.0,8,1140,0,47.7637,1850
3761,3,2.0,1010,1.0,8,1010,0,47.6232,1750
3762,5,3.0,3350,2.0,8,2180,1170,47.6705,2660
3763,5,3.5,3450,1.0,8,2350,1100,47.6991,2640
3764,3,2.5,1670,2.0,8,1670,0,47.5314,1670
3765,2,1.75,1510,1.0,8,1510,0,47.6644,1740
3766,3,2.0,1260,1.0,7,1260,0,47.4034,1460
3767,4,2.5,3180,1.0,10,2390,790,47.6388,3180
3768,4,2.5,2500,2.0,7,2500,0,47.3853,1960
3769,3,1.0,1340,1.0,7,1340,0,47.3173,1250
3770,3,1.5,910,1.0,6,910,0,47.5238,1410
3771,3,1.5,910,1.0,6,910,0,47.5238,1410
3772,4,3.5,2370,2.0,8,1610,760,47.684,2170
3773,2,1.0,1380,2.0,7,1080,300,47.6416,1600
3774,2,1.75,1660,2.0,7,1660,0,47.4899,1290
3775,3,2.25,2370,2.0,7,2370,0,47.5827,2370
3776,4,1.75,2030,1.0,7,1450,580,47.5067,1750
3777,3,1.75,1620,1.0,7,1310,310,47.3635,1580
3778,3,2.25,1720,1.0,7,1140,580,47.6882,1530
3779,4,1.75,2340,1.0,7,1170,1170,47.6746,1270
3780,4,2.0,1650,1.0,7,1650,0,47.6781,1690
3781,3,2.25,2300,2.0,8,2300,0,47.5677,2240
3782,1,1.0,620,1.0,5,620,0,47.5138,1180
3783,1,1.0,620,1.0,5,620,0,47.5138,1180
3784,3,2.5,2190,1.0,8,1550,640,47.6685,2190
3785,3,3.25,3740,2.5,11,3100,640,47.4549,2400
3786,4,2.5,2810,2.0,9,2810,0,47.7441,2750
3787,3,2.0,1480,1.0,7,740,740,47.5081,1250
3788,3,2.25,1358,3.0,7,1358,0,47.7052,1358
3789,4,1.75,1830,2.0,8,1230,600,47.5449,3630
3790,4,1.0,1530,2.0,7,1530,0,47.3638,1470
3791,2,1.0,810,1.0,6,810,0,47.7317,1500
3792,6,4.0,3020,2.0,8,2840,180,47.5924,3680
3793,4,2.75,2620,1.0,8,1310,1310,47.6829,1900
3794,2,1.0,1110,1.0,6,1110,0,47.4962,1150
3795,4,2.5,2650,2.0,9,2650,0,47.6278,2650
3796,3,1.0,1450,1.5,7,1450,0,47.4299,1360
3797,3,1.75,1530,1.0,7,1100,430,47.6949,1780
3798,3,1.5,1590,1.0,7,1590,0,47.7394,1590
3799,3,1.0,990,1.0,7,990,0,47.3422,1360
3800,3,2.0,2080,1.0,7,1040,1040,47.5791,1710
3801,3,2.75,1400,1.0,7,1000,400,47.5095,1400
3802,4,4.25,4285,2.0,10,4285,0,47.6332,1570
3803,3,1.0,1260,1.0,7,1260,0,47.7,1560
3804,3,1.5,1730,2.0,8,1730,0,47.7499,1730
3805,3,2.0,2520,1.5,8,1410,1110,47.6365,1960
3806,3,1.75,1550,1.0,7,1550,0,47.6136,1360
3807,2,1.75,1170,2.0,9,780,390,47.6192,1280
3808,3,1.0,1300,1.0,6,1300,0,47.6829,1440
3809,3,1.0,1110,1.0,7,1110,0,47.6461,1460
3810,4,2.25,1890,1.0,9,1470,420,47.6316,2430
3811,3,1.5,1100,2.0,8,940,160,47.5927,1380
3812,3,2.5,3020,1.0,8,1510,1510,47.5529,2400
3813,2,1.75,1160,1.0,6,1160,0,47.5509,960
3814,3,1.75,2190,1.0,8,2190,0,47.3098,1980
3815,3,2.5,2030,2.0,8,2030,0,47.5654,2030
3816,3,1.75,1700,1.5,7,1450,250,47.5643,1700
3817,4,2.75,3010,2.0,9,3010,0,47.7005,3010
3818,4,2.5,2280,1.0,8,1500,780,47.5392,2690
3819,4,2.0,2020,1.5,7,1160,860,47.7307,1840
3820,3,1.0,1250,1.0,7,1250,0,47.5074,1770
3821,2,1.0,1000,1.0,7,1000,0,47.5474,1280
3822,4,3.0,3600,1.0,9,2100,1500,47.5866,2700
3823,2,1.75,1660,1.0,7,830,830,47.7661,1900
3824,3,1.75,1820,1.0,7,1820,0,47.3352,1420
3825,7,2.75,3110,1.5,7,2010,1100,47.6684,1240
3826,7,1.0,2350,1.0,7,1550,800,47.5432,1500
3827,3,1.0,1200,1.0,6,1200,0,47.3262,1160
3828,3,2.5,1800,2.0,7,1240,560,47.646,1790
3829,3,2.0,1430,1.0,7,1430,0,47.7564,1630
3830,4,2.5,2330,2.0,8,2330,0,47.6471,2460
3831,4,1.5,1960,1.5,7,1960,0,47.6304,2050
3832,4,2.5,3510,2.0,10,3510,0,47.6016,3320
3833,2,1.0,910,1.0,5,910,0,47.6916,1020
3834,4,2.25,2120,2.0,7,2120,0,47.2041,2120
3835,3,1.0,1270,1.0,6,1270,0,47.6175,1210
3836,3,2.0,1670,1.0,7,1150,520,47.6096,2020
3837,2,1.0,1640,1.0,7,940,700,47.6912,2054
3838,3,2.25,1740,1.0,7,1110,630,47.4149,1640
3839,0,2.5,1490,2.0,7,1490,0,47.5261,1500
3840,3,2.5,2240,2.0,7,2240,0,47.6786,1460
3841,4,1.75,2040,2.0,9,2040,0,47.6279,3220
3842,3,1.5,990,1.0,7,990,0,47.3294,1360
3843,2,1.0,870,1.0,6,870,0,47.498000000000005,1020
3844,3,2.5,1740,2.0,7,1740,0,47.3574,1260
3845,2,1.75,1390,1.5,8,1390,0,47.6701,2160
3846,3,2.5,2030,1.0,8,2030,0,47.6187,2040
3847,3,1.0,1890,1.0,7,1890,0,47.5719,1746
3848,3,1.0,1610,1.0,7,1610,0,47.6718,2510
3849,4,2.0,1820,2.0,7,1820,0,47.6438,1440
3850,3,1.5,2290,1.0,7,2290,0,47.3643,1310
3851,3,1.75,1110,1.0,7,1110,0,47.5676,2050
3852,3,3.5,3070,1.0,8,1570,1500,47.7076,2350
3853,4,1.75,2340,1.0,8,1590,750,47.497,1970
3854,3,1.0,1190,1.0,7,1190,0,47.4116,1190
3855,3,2.5,2600,2.0,8,2600,0,47.7353,2600
3856,2,1.0,910,1.0,6,910,0,47.675,1740
3857,3,2.5,1760,2.0,8,1760,0,47.5723,1760
3858,4,1.75,2000,1.5,9,1820,180,47.643,1950
3859,2,1.0,1020,1.5,6,1020,0,47.4956,1480
3860,5,2.5,4600,1.5,9,3600,1000,47.623000000000005,5500
3861,5,3.0,2008,1.0,7,1216,792,47.5376,2040
3862,3,1.75,1700,1.0,7,850,850,47.5766,1520
3863,3,2.5,2170,2.0,7,2170,0,47.3817,2020
3864,4,2.75,2520,2.0,8,2520,0,47.7685,2520
3865,2,1.0,1230,1.5,7,880,350,47.6815,1710
3866,3,1.0,1450,1.0,7,1450,0,47.5238,1170
3867,4,3.75,3180,2.0,9,2500,680,47.6853,2910
3868,4,2.25,2020,2.0,8,2020,0,47.5403,1800
3869,4,2.25,1980,1.0,7,1470,510,47.3669,1980
3870,4,1.75,2180,1.0,8,1180,1000,47.405,2180
3871,4,1.75,1770,1.0,8,1370,400,47.6208,2040
3872,3,2.5,2880,2.0,7,2880,0,47.2485,1460
3873,3,1.75,2520,1.0,8,1260,1260,47.5339,1360
3874,4,2.5,3170,2.0,7,3170,0,47.4911,3010
3875,3,1.75,1870,2.0,7,1870,0,47.695,1870
3876,3,1.5,1370,2.0,7,1370,0,47.7253,1370
3877,4,2.5,1700,1.0,7,1700,0,47.7306,1370
3878,4,2.5,2460,2.0,7,2460,0,47.5381,2320
3879,4,2.0,1580,1.0,7,1040,540,47.3467,1550
3880,4,1.75,2180,1.0,7,1090,1090,47.4973,2020
3881,3,2.75,1950,1.0,8,1230,720,47.6301,1990
3882,4,2.5,2320,2.0,8,2320,0,47.3432,2230
3883,4,2.5,2670,2.0,9,2670,0,47.5627,2560
3884,4,3.5,3650,2.0,10,3650,0,47.7711,3730
3885,2,1.0,720,1.0,6,720,0,47.5176,990
3886,3,2.0,1380,1.0,7,1380,0,47.5514,1320
3887,3,1.75,1170,1.0,7,1170,0,47.3279,1230
3888,3,1.75,1890,1.0,8,1890,0,47.7032,1920
3889,3,1.0,1010,1.0,7,1010,0,47.3592,1240
3890,4,3.0,2580,2.0,8,2580,0,47.4296,2010
3891,4,2.5,2290,2.0,8,2290,0,47.5714,2100
3892,4,2.5,3490,2.0,8,3490,0,47.3772,2910
3893,3,1.0,1790,1.0,8,1520,270,47.718,1710
3894,3,2.5,1780,1.0,7,1230,550,47.5237,1780
3895,2,1.0,1110,1.0,6,700,410,47.5454,2830
3896,2,1.0,800,1.0,6,800,0,47.6836,2390
3897,3,1.0,1680,1.0,7,1680,0,47.5085,1330
3898,4,1.75,2780,1.0,9,1560,1220,47.595,2350
3899,4,3.0,3150,2.0,9,3150,0,47.5962,3150
3900,3,2.5,2970,1.0,7,1510,1460,47.7735,2390
3901,3,2.5,2970,1.0,7,1510,1460,47.7735,2390
3902,2,1.0,1190,1.0,6,830,360,47.5094,1140
3903,1,1.0,900,1.0,5,900,0,47.7553,1470
3904,3,3.25,2950,2.0,9,2450,500,47.5852,1930
3905,3,1.0,1020,1.0,6,1020,0,47.3127,1600
3906,3,2.5,2030,2.0,7,2030,0,47.4024,2290
3907,4,3.5,4220,2.0,10,4220,0,47.2642,2500
3908,3,2.5,2390,1.0,8,1840,550,47.3546,2460
3909,2,1.0,910,1.0,6,910,0,47.5322,1620
3910,3,2.0,1550,1.0,7,1550,0,47.5755,2900
3911,4,2.75,2060,1.0,7,1310,750,47.3581,1540
3912,3,2.0,2360,2.0,7,2360,0,47.483,1650
3913,3,2.25,1420,2.0,7,1420,0,47.5725,1430
3914,3,1.5,1360,1.5,7,1360,0,47.4648,1310
3915,4,3.0,3680,1.5,8,2320,1360,47.4703,3210
3916,2,0.75,1330,1.0,7,930,400,47.5671,1330
3917,4,1.0,1530,1.5,7,1400,130,47.5015,1530
3918,3,1.0,960,1.0,7,960,0,47.7763,1080
3919,3,1.0,1080,1.0,7,1080,0,47.7401,1850
3920,3,2.0,1610,1.0,7,1010,600,47.5421,1040
3921,4,2.75,4270,2.0,11,4270,0,47.5951,3860
3922,8,3.75,3460,2.0,7,2860,600,47.6617,2170
3923,3,1.5,1330,1.0,7,1330,0,47.7167,1940
3924,3,2.25,2840,1.0,7,1580,1260,47.5828,2220
3925,3,1.75,2000,1.0,6,2000,0,47.5217,2100
3926,3,2.5,2190,2.0,9,2190,0,47.6528,2315
3927,4,2.5,3100,2.0,9,3100,0,47.6961,1240
3928,6,4.0,3120,2.0,7,2090,1030,47.5305,1460
3929,2,1.0,1010,1.0,7,1010,0,47.6715,1410
3930,4,2.5,4020,2.0,10,4020,0,47.7467,3440
3931,4,2.5,2660,2.0,9,2660,0,47.4816,2330
3932,4,2.5,2120,2.0,8,2120,0,47.5348,1990
3933,3,2.25,1780,2.0,7,1780,0,47.7484,1780
3934,4,2.5,2000,1.0,7,1200,800,47.353,1800
3935,3,2.0,2180,1.5,8,1680,500,47.573,1850
3936,3,2.0,1790,1.0,7,1390,400,47.4658,1880
3937,2,1.5,1800,1.0,7,900,900,47.5934,2090
3938,3,2.25,2620,1.0,7,1660,960,47.7643,1820
3939,3,3.0,2790,2.0,8,1600,1190,47.3571,2990
3940,2,1.75,2090,1.0,7,1090,1000,47.4594,1940
3941,4,2.5,2040,2.0,7,2040,0,47.7399,2040
3942,4,2.5,2930,2.0,9,2930,0,47.7065,3590
3943,3,2.0,1990,1.0,7,1990,0,47.2507,2760
3944,3,1.0,1060,1.0,6,1060,0,47.2869,1060
3945,3,1.0,1220,1.0,7,1220,0,47.6088,1390
3946,3,1.75,1430,1.0,7,1430,0,47.6371,1750
3947,2,1.0,780,1.0,7,780,0,47.4913,1090
3948,2,1.0,750,1.0,6,750,0,47.5324,1030
3949,3,1.0,900,1.0,6,900,0,47.3038,900
3950,3,1.0,940,1.0,6,940,0,47.4516,1210
3951,3,1.0,1040,1.0,7,1040,0,47.7287,1160
3952,3,1.0,1610,1.5,7,1610,0,47.3717,1070
3953,5,1.0,1600,1.0,7,1600,0,47.3943,1600
3954,3,3.0,1730,3.0,7,1730,0,47.6911,1690
3955,3,1.0,1380,1.0,7,1380,0,47.5139,1320
3956,2,1.0,720,1.0,6,720,0,47.5286,1030
3957,3,1.0,1070,1.0,7,1070,0,47.7207,1170
3958,4,2.5,2000,2.0,8,2000,0,47.3552,2000
3959,3,2.5,2060,2.0,8,2060,0,47.5675,2180
3960,3,2.25,1740,1.0,7,1240,500,47.2979,1740
3961,3,2.25,1740,1.0,7,1240,500,47.2979,1740
3962,3,2.5,3280,1.0,11,2670,610,47.6395,3280
3963,3,2.25,1740,1.0,8,1240,500,47.7758,2080
3964,4,1.75,2430,1.0,8,1430,1000,47.5569,2050
3965,3,1.5,1740,1.0,7,1600,140,47.7211,1650
3966,4,2.5,3420,2.0,10,3420,0,47.6328,3230
3967,5,2.5,2240,1.0,7,1140,1100,47.7756,2110
3968,4,1.75,2020,1.0,7,1430,590,47.6983,1780
3969,2,1.75,1390,1.0,6,720,670,47.6914,920
3970,4,1.5,2190,2.0,7,2190,0,47.5158,1160
3971,1,1.0,640,1.0,5,640,0,47.5144,1090
3972,3,1.5,1240,1.0,7,1240,0,47.4478,1570
3973,5,1.75,1850,1.5,6,1760,90,47.4935,1250
3974,5,3.5,2730,1.0,8,1530,1200,47.4587,3180
3975,3,2.25,1670,1.0,7,1190,480,47.4105,1870
3976,2,1.0,1010,1.5,5,1010,0,47.7105,830
3977,4,1.0,1400,1.0,6,700,700,47.5972,1690
3978,3,1.75,1270,1.0,7,1270,0,47.6046,1880
3979,4,2.0,1660,1.0,6,850,810,47.5371,1110
3980,3,2.75,2800,1.0,7,1400,1400,47.5862,2800
3981,3,1.0,990,1.0,6,990,0,47.4839,1210
3982,4,2.0,2160,2.0,7,1290,870,47.4777,1570
3983,3,3.0,1850,1.0,7,1090,760,47.3493,1410
3984,7,3.25,4340,2.0,7,2550,1790,47.52,1890
3985,3,2.5,1980,2.0,8,1980,0,47.1903,2050
3986,5,5.0,3960,2.0,10,3960,0,47.38,2240
3987,4,2.5,2130,2.0,8,2130,0,47.4518,1940
3988,3,2.5,1720,2.0,7,1720,0,47.4033,1720
3989,4,2.25,2200,2.0,7,2200,0,47.3595,1740
3990,4,2.5,3120,2.0,9,3120,0,47.5318,2580
3991,2,1.0,950,1.0,6,950,0,47.687,1660
3992,4,3.25,3680,2.0,9,2840,840,47.5367,3620
3993,3,1.0,960,1.0,7,960,0,47.7766,1120
3994,4,2.5,1990,2.0,7,1990,0,47.3078,1862
3995,4,2.5,1710,1.0,8,1110,600,47.6772,1750
3996,3,1.75,1440,1.0,7,960,480,47.7128,1500
3997,3,1.0,1480,1.0,7,1480,0,47.7703,1450
3998,4,2.5,2960,2.0,10,2960,0,47.5075,2500
3999,3,2.5,1650,1.0,7,1130,520,47.4821,1940
4000,3,2.5,1950,2.0,8,1950,0,47.6363,1860
4001,3,1.75,1300,1.0,7,1300,0,47.6529,1850
4002,3,2.5,1930,2.0,8,1930,0,47.7191,1930
4003,4,2.0,1700,1.0,7,850,850,47.4758,1540
4004,4,2.0,1700,1.0,7,850,850,47.4758,1540
4005,4,2.5,2570,1.0,8,1570,1000,47.6921,2440
4006,4,3.5,4390,2.0,11,3060,1330,47.5862,3240
4007,4,2.25,1860,1.0,8,1860,0,47.4524,1860
4008,4,2.75,2150,1.0,8,1220,930,47.7758,2060
4009,3,1.0,1010,1.0,7,1010,0,47.6208,1300
4010,4,2.0,3390,2.0,10,3390,0,47.7222,3950
4011,2,1.0,1210,1.0,7,1210,0,47.3752,2250
4012,3,2.5,2740,2.0,7,2740,0,47.473,1470
4013,3,2.5,2300,2.0,9,2300,0,47.4181,2570
4014,4,3.0,2780,1.5,7,1710,1070,47.5721,1150
4015,3,2.5,1780,2.0,8,1780,0,47.2578,2040
4016,2,1.0,940,1.0,8,940,0,47.6631,1440
4017,4,2.25,2470,2.0,8,2470,0,47.5924,2470
4018,4,2.0,1460,1.0,6,1460,0,47.5056,1460
4019,2,1.0,1320,1.0,6,940,380,47.5693,1970
4020,5,3.0,2640,2.0,10,2640,0,47.6809,1610
4021,2,1.0,1240,1.0,7,1060,180,47.5493,1240
4022,3,2.5,1610,2.0,7,1610,0,47.3833,1790
4023,3,2.75,2290,1.0,7,1400,890,47.5343,2540
4024,4,1.5,1440,1.0,7,960,480,47.5269,1650
4025,3,2.5,1850,1.0,7,1250,600,47.434,1930
4026,3,1.75,1620,1.0,7,940,680,47.6786,1320
4027,3,1.5,1200,2.0,8,1200,0,47.4658,1270
4028,3,2.5,3630,2.0,11,3630,0,47.6544,3250
4029,3,1.0,1170,1.0,7,1170,0,47.5448,1380
4030,2,1.5,1460,1.5,7,1460,0,47.6838,1780
4031,4,1.5,2700,1.5,9,2700,0,47.1996,1670
4032,3,1.75,1880,1.0,7,1040,840,47.6878,1770
4033,3,2.5,1808,1.0,8,1808,0,47.2598,1450
4034,3,1.75,1950,1.0,7,1950,0,47.7685,1950
4035,4,1.0,1460,1.0,6,1460,0,47.3431,1460
4036,3,2.25,1470,1.0,7,1180,290,47.4547,1900
4037,4,3.0,3350,2.0,10,3350,0,47.3602,3350
4038,4,3.0,3350,2.0,10,3350,0,47.3602,3350
4039,4,1.0,1360,1.0,7,1360,0,47.7366,1570
4040,3,1.0,1020,1.0,7,1020,0,47.3587,1650
4041,3,2.25,1840,1.0,7,1270,570,47.4075,1750
4042,3,1.75,2140,1.0,7,1240,900,47.5074,1640
4043,4,1.75,1760,1.0,7,880,880,47.6889,1500
4044,2,2.25,2320,2.0,8,2320,0,47.3905,1610
4045,4,1.75,1260,1.0,6,1260,0,47.5267,1880
4046,2,1.0,1650,1.0,7,950,700,47.6549,1650
4047,1,1.0,790,1.0,6,790,0,47.5146,1900
4048,3,1.75,1850,1.5,8,1210,640,47.5853,1660
4049,3,2.25,1352,3.0,8,1352,0,47.7265,1439
4050,3,1.0,1350,1.5,7,1350,0,47.5749,1360
4051,3,1.0,1040,1.0,7,1040,0,47.3171,1200
4052,3,1.0,1010,1.0,6,1010,0,47.7416,1010
4053,3,2.25,1740,1.0,7,910,830,47.3976,2090
4054,3,2.25,1330,2.0,7,1330,0,47.7098,1300
4055,3,1.0,1690,1.0,7,1210,480,47.4256,1190
4056,3,1.0,1070,1.0,7,1070,0,47.7425,1710
4057,2,1.75,2230,1.0,8,1530,700,47.6705,1970
4058,3,2.5,2590,2.0,9,2590,0,47.5271,1230
4059,4,1.75,1820,1.0,7,1820,0,47.606,1430
4060,3,2.5,1480,3.0,8,1480,0,47.6199,1480
4061,3,1.75,2140,1.0,7,1460,680,47.3099,2090
4062,3,2.25,2950,1.5,9,2950,0,47.5917,3880
4063,3,1.75,1660,1.0,7,1660,0,47.74100000000001,1770
4064,3,1.75,1830,1.0,7,930,900,47.5723,1320
4065,4,3.25,2557,2.0,7,2557,0,47.5449,2220
4066,3,2.5,2350,1.0,8,1570,780,47.3126,2270
4067,3,2.5,1690,2.0,7,1690,0,47.6885,1650
4068,4,2.5,2660,2.0,9,2660,0,47.5445,3010
4069,4,4.0,4550,1.0,9,2300,2250,47.5964,3540
4070,3,3.0,1530,1.0,7,1150,380,47.6869,1530
4071,4,1.75,1880,1.0,7,1880,0,47.5838,1750
4072,3,2.0,1370,1.0,7,1370,0,47.2802,1660
4073,2,1.0,770,1.0,6,770,0,47.7547,1290
4074,2,2.25,2950,1.0,8,1560,1390,47.6209,2060
4075,3,2.75,2440,1.0,10,1640,800,47.7672,1890
4076,4,1.0,2080,1.5,7,1260,820,47.5445,1380
4077,3,2.5,1060,2.0,8,1060,0,47.6907,1220
4078,4,3.5,4440,2.0,11,4440,0,47.5294,4390
4079,3,1.0,1580,2.0,8,1580,0,47.6363,2190
4080,5,2.75,3630,2.0,11,3630,0,47.4289,4440
4081,4,2.75,1960,1.0,7,1000,960,47.5693,1830
4082,3,2.75,2290,2.0,7,2290,0,47.3691,399
4083,3,2.5,1530,1.5,7,1010,520,47.6913,1330
4084,2,1.5,1450,1.0,7,1450,0,47.7281,1890
4085,3,2.25,1690,2.0,7,1690,0,47.3889,1520
4086,2,2.0,1320,3.0,7,1320,0,47.7223,1430
4087,4,2.5,3070,2.0,10,3070,0,47.5399,3320
4088,6,4.0,3300,1.0,8,1960,1340,47.676,2030
4089,4,1.75,1880,1.5,7,1090,790,47.6646,1700
4090,3,2.0,2290,1.0,9,1670,620,47.5692,2750
4091,4,3.5,3860,2.0,10,3120,740,47.7095,3550
4092,4,3.25,3020,1.5,8,1920,1100,47.6395,2400
4093,2,2.0,2280,2.0,9,2280,0,47.4125,2030
4094,2,1.5,1050,2.0,8,960,90,47.6028,1470
4095,4,2.5,1720,2.0,8,1720,0,47.2704,1870
4096,3,2.25,2520,2.0,9,1590,930,47.7384,2000
4097,3,2.0,1520,1.0,7,1140,380,47.6326,1280
4098,4,2.5,3480,2.0,9,2360,1120,47.6841,3620
4099,6,3.25,3870,2.0,10,2520,1350,47.7517,2360
4100,3,2.5,1710,2.0,7,1710,0,47.7232,1540
4101,3,1.5,1850,1.0,7,1850,0,47.7275,1530
4102,2,2.0,1370,1.0,8,950,420,47.6589,1370
4103,3,3.0,2400,2.0,7,2400,0,47.6963,1360
4104,3,2.5,2620,1.0,7,1310,1310,47.2584,2330
4105,4,2.5,2980,2.0,9,2980,0,47.5515,2980
4106,2,1.0,1480,1.0,7,1120,360,47.2079,1670
4107,4,2.5,2240,1.0,7,1370,870,47.31399999999999,1980
4108,4,1.0,1460,1.5,5,1460,0,47.5006,1320
4109,3,1.0,1530,1.0,8,1290,240,47.4508,2090
4110,5,1.0,2230,1.5,7,1700,530,47.5161,2730
4111,4,1.5,1680,1.0,7,1180,500,47.4578,1460
4112,2,1.0,1250,1.0,6,1250,0,47.5158,1040
4113,4,1.75,1480,1.0,7,1480,0,47.5064,1480
4114,3,1.0,1390,1.0,5,1390,0,47.4977,1170
4115,4,2.5,2960,2.0,9,2960,0,47.5544,2960
4116,5,1.5,1500,1.0,6,760,740,47.4692,1200
4117,3,1.75,1200,1.0,6,1200,0,47.4959,1270
4118,5,2.25,2180,1.0,8,1430,750,47.6235,2160
4119,3,2.5,2020,2.0,7,2020,0,47.6835,2020
4120,3,2.5,2480,2.0,9,2480,0,47.771,2480
4121,3,1.0,2150,1.0,8,1610,540,47.6996,1620
4122,3,2.5,1590,2.0,7,1590,0,47.5515,1090
4123,3,2.5,3350,2.0,8,2550,800,47.7277,2340
4124,4,2.5,3000,2.0,7,3000,0,47.3655,1890
4125,4,1.0,1200,1.5,7,1200,0,47.5372,1810
4126,1,1.75,1440,1.0,7,720,720,47.534,1440
4127,3,1.75,1440,1.0,7,990,450,47.4333,1550
4128,5,2.0,1750,1.0,7,1750,0,47.7694,1210
4129,3,2.25,1600,2.0,8,1600,0,47.7523,2320
4130,4,1.75,3720,1.0,9,1960,1760,47.6425,2540
4131,4,2.5,2080,1.0,8,2080,0,47.472,1850
4132,5,3.0,2257,1.0,8,1363,894,47.4524,1540
4133,3,1.75,1950,1.0,8,1530,420,47.6934,1660
4134,2,1.75,1740,1.5,7,1040,700,47.5994,2020
4135,4,2.5,2440,2.0,7,2440,0,47.3817,1860
4136,3,2.75,1810,2.0,8,1810,0,47.5164,1810
4137,3,3.0,2520,1.5,8,1560,960,47.6363,1140
4138,3,2.25,2880,2.0,10,2880,0,47.5575,2920
4139,2,1.0,930,1.0,5,930,0,47.4611,1620
4140,2,1.0,930,1.0,5,930,0,47.4611,1620
4141,2,1.75,1460,1.0,7,960,500,47.2079,1810
4142,3,3.25,3140,2.0,10,2240,900,47.6406,2950
4143,5,2.75,3100,1.0,9,1660,1440,47.5734,3230
4144,3,2.0,1800,1.0,8,1220,580,47.6254,2460
4145,3,1.0,1710,1.5,7,1200,510,47.7185,1410
4146,3,2.0,1400,1.0,6,700,700,47.7634,1410
4147,3,1.0,1220,1.0,7,1220,0,47.2633,1260
4148,3,2.75,2300,2.0,8,2300,0,47.5216,2420
4149,2,1.0,1520,2.0,7,1520,0,47.3187,1140
4150,2,1.0,1440,1.0,7,960,480,47.6653,1160
4151,3,1.75,1170,1.0,7,1170,0,47.7479,1200
4152,3,1.75,1170,1.0,7,1170,0,47.7479,1200
4153,3,2.5,3240,2.0,8,3240,0,47.4785,1870
4154,2,1.0,980,1.0,7,980,0,47.6569,1570
4155,3,1.0,2230,1.0,7,1230,1000,47.5215,2380
4156,3,1.75,1660,1.0,7,1660,0,47.5375,1610
4157,5,2.5,1630,1.0,7,1100,530,47.3657,1630
4158,5,1.0,2150,1.5,7,2150,0,47.5519,1460
4159,4,2.5,2890,2.0,9,2890,0,47.5666,3090
4160,4,2.5,1600,1.0,8,1310,290,47.7258,1600
4161,2,1.5,1280,1.0,7,850,430,47.6351,1280
4162,4,2.5,2680,2.0,8,2680,0,47.3025,1960
4163,3,1.75,1770,1.0,8,1270,500,47.3109,2120
4164,4,2.5,2100,2.0,8,2100,0,47.3703,2060
4165,2,2.0,1340,1.0,7,1340,0,47.1936,1670
4166,3,1.5,1910,1.5,7,1910,0,47.2782,1770
4167,4,4.5,5270,2.0,11,3400,1870,47.5696,3390
4168,3,1.0,1010,1.0,6,1010,0,47.1955,1090
4169,5,1.75,2870,1.0,9,1440,1430,47.6122,2940
4170,4,1.75,1970,1.0,7,1140,830,47.4861,1710
4171,2,1.0,790,1.0,7,790,0,47.5543,960
4172,5,2.5,2350,2.0,9,2350,0,47.6265,1840
4173,5,2.5,2350,2.0,9,2350,0,47.6265,1840
4174,4,3.0,3220,1.5,9,3220,0,47.4813,2950
4175,3,2.25,1580,2.0,7,1580,0,47.68600000000001,2253
4176,3,1.75,1750,1.0,7,1300,450,47.6099,2310
4177,4,2.75,1810,1.0,7,1200,610,47.3703,1750
4178,3,1.75,1800,1.0,7,900,900,47.6867,1800
4179,3,1.0,940,1.0,6,940,0,47.6195,1230
4180,3,1.0,840,1.0,6,840,0,47.3277,840
4181,3,1.0,840,1.0,6,840,0,47.3277,840
4182,3,1.75,4060,1.0,8,2810,1250,47.4843,1300
4183,3,1.0,1010,1.0,7,1010,0,47.7467,1220
4184,3,1.0,1100,1.5,7,1100,0,47.6604,1770
4185,4,3.25,5370,2.0,11,5370,0,47.405,2770
4186,2,1.0,1010,1.0,6,890,120,47.5323,1030
4187,2,1.0,820,1.0,5,820,0,47.5479,1300
4188,5,2.5,4340,1.0,8,2170,2170,47.5384,2030
4189,3,1.75,2100,1.0,8,1440,660,47.4294,2000
4190,4,1.75,1250,1.0,7,910,340,47.4138,1410
4191,6,3.0,3870,2.0,8,2700,1170,47.7642,2600
4192,2,2.5,1380,3.0,9,1380,0,47.6654,1430
4193,3,2.25,3100,1.0,7,1790,1310,47.3825,1770
4194,4,1.75,1400,1.0,7,1400,0,47.36,2170
4195,3,1.75,1560,1.0,8,1560,0,47.6981,1370
4196,3,2.5,2390,2.0,9,2390,0,47.6271,2370
4197,3,1.0,1360,1.0,5,1360,0,47.4945,1250
4198,3,1.75,2300,1.0,8,2300,0,47.7588,2720
4199,4,2.25,3040,1.0,9,1940,1100,47.5923,2430
4200,3,1.0,960,1.0,7,960,0,47.6465,1550
4201,3,1.0,1480,1.0,7,1480,0,47.5942,1430
4202,3,2.0,1560,1.0,7,1150,410,47.6913,1560
4203,2,1.5,900,1.0,7,900,0,47.5623,1300
4204,4,1.75,2400,1.5,7,1500,900,47.7125,1530
4205,2,1.0,1430,1.0,7,1010,420,47.513000000000005,2300
4206,2,1.0,1250,1.0,7,850,400,47.6549,1520
4207,3,2.25,1650,2.0,7,1650,0,47.3826,2010
4208,4,3.0,2580,2.0,7,2130,450,47.3726,1900
4209,3,1.0,1560,1.5,7,1260,300,47.5554,1560
4210,5,2.75,2880,1.0,9,1660,1220,47.6267,3750
4211,3,2.0,2110,2.0,7,2110,0,47.5836,2690
4212,4,2.75,2280,1.5,7,1540,740,47.6871,1680
4213,3,2.0,1990,2.0,8,1990,0,47.4726,2120
4214,3,2.5,2650,2.0,8,1830,820,47.6315,1870
4215,4,2.5,2290,2.0,8,2290,0,47.57,2150
4216,3,2.5,2680,2.0,9,2680,0,47.7043,2780
4217,3,1.0,1200,1.0,7,1200,0,47.7412,1220
4218,3,1.0,1000,1.0,7,1000,0,47.7142,1000
4219,3,2.75,1830,2.0,10,1690,140,47.5307,2310
4220,3,2.0,2260,1.0,7,1130,1130,47.4544,2080
4221,3,1.75,1510,1.0,7,1510,0,47.684,1310
4222,3,2.5,2080,2.0,8,2080,0,47.5469,1760
4223,2,2.0,1860,1.0,8,1260,600,47.4989,1250
4224,3,2.0,1110,1.0,7,1110,0,47.6978,1410
4225,3,1.75,1520,1.0,8,1520,0,47.3308,2270
4226,3,1.75,1730,1.0,7,1150,580,47.6923,1900
4227,3,1.5,1380,1.0,7,790,590,47.3489,1570
4228,3,1.5,1780,1.0,7,1780,0,47.4912,1130
4229,3,2.25,1630,2.0,7,1630,0,47.4279,1730
4230,3,2.5,2580,2.0,9,2580,0,47.6201,2480
4231,3,2.5,1960,2.0,7,1960,0,47.5322,1700
4232,3,1.75,1810,1.0,9,930,880,47.5314,3540
4233,3,2.25,2550,2.0,9,2550,0,47.6272,1680
4234,3,2.25,1920,2.0,8,1920,0,47.6432,2000
4235,4,2.5,2961,2.0,9,2961,0,47.5839,2620
4236,4,2.75,2390,2.0,8,2390,0,47.5703,2090
4237,4,2.5,1900,1.5,7,1900,0,47.3776,1240
4238,2,1.0,1040,1.0,7,940,100,47.6829,1420
4239,3,2.5,1970,2.0,7,1970,0,47.5321,1970
4240,3,2.5,1960,2.0,8,1960,0,47.7371,2520
4241,3,3.25,2660,2.0,9,2170,490,47.6186,2660
4242,3,2.25,1180,2.0,7,1180,0,47.7112,1860
4243,5,3.0,2600,1.0,8,1300,1300,47.7176,2150
4244,5,3.0,3880,2.0,10,3880,0,47.5467,3470
4245,3,2.5,1530,2.0,7,1530,0,47.6939,1370
4246,3,1.75,2430,2.0,7,1760,670,47.6785,1320
4247,2,2.0,2100,2.0,9,2100,0,47.72,1440
4248,2,2.5,1100,2.0,8,1100,0,47.4499,1610
4249,2,1.0,1070,1.0,6,1070,0,47.3336,1150
4250,3,1.0,1280,1.5,6,1280,0,47.3215,1610
4251,3,1.75,2450,1.0,7,1980,470,47.6957,1790
4252,4,2.25,1970,1.0,7,1370,600,47.7673,2390
4253,3,1.75,1270,1.0,7,1270,0,47.7601,1470
4254,3,1.75,1570,1.0,7,1310,260,47.3621,1380
4255,3,1.0,1060,1.0,7,1060,0,47.4432,1310
4256,3,1.0,1160,1.0,6,1160,0,47.5097,1300
4257,2,1.0,860,1.0,7,860,0,47.6652,1490
4258,3,2.5,1950,2.0,7,1950,0,47.4068,1890
4259,3,2.5,1970,2.0,7,1090,880,47.3462,2020
4260,7,3.0,5350,2.5,10,5020,330,47.6295,3050
4261,4,2.5,2490,2.0,7,2490,0,47.4813,2510
4262,2,1.0,1060,1.0,6,1060,0,47.3613,1130
4263,2,2.0,1300,1.0,8,1300,0,47.7132,1640
4264,3,1.0,1610,1.5,7,1010,600,47.6765,1270
4265,4,1.75,2120,2.0,8,2120,0,47.457,1820
4266,4,2.25,2530,1.5,7,1690,840,47.6806,1530
4267,5,2.5,2620,1.0,8,1520,1100,47.6919,2030
4268,3,1.0,980,1.0,7,980,0,47.7292,1280
4269,3,2.5,1620,2.0,8,1100,520,47.6195,1620
4270,4,2.25,1600,2.0,7,1600,0,47.194,1540
4271,4,2.5,1790,2.0,7,1790,0,47.3994,1790
4272,4,1.0,1370,1.5,5,1370,0,47.2716,1590
4273,5,4.75,6200,2.0,11,4440,1760,47.605,2940
4274,4,2.25,2180,1.0,8,1370,810,47.6042,2090
4275,4,1.5,1730,1.5,7,1730,0,47.4905,1510
4276,2,1.0,1000,1.0,5,1000,0,47.5935,1930
4277,4,2.5,3010,2.0,9,3010,0,47.522,2670
4278,4,3.25,2050,2.0,8,1370,680,47.6235,1720
4279,2,1.0,1090,1.0,7,780,310,47.632,1160
4280,3,1.0,1000,1.0,7,1000,0,47.7285,1270
4281,5,3.25,4410,2.0,9,2330,2080,47.4395,2460
4282,2,1.0,920,1.0,6,920,0,47.5028,1410
4283,3,1.75,1860,1.5,8,1860,0,47.5051,1410
4284,3,2.5,2210,2.0,7,1710,500,47.5525,1350
4285,3,1.75,2060,2.0,9,1500,560,47.6498,1830
4286,3,2.5,1780,2.0,8,1780,0,47.5677,1730
4287,4,2.5,3030,2.0,9,3030,0,47.6296,2310
4288,4,2.25,1450,1.0,7,1450,0,47.7643,1660
4289,3,2.25,3230,2.0,9,3230,0,47.5683,3690
4290,4,1.0,1410,1.5,7,1410,0,47.3767,1540
4291,4,2.25,2530,1.0,8,1320,1210,47.5698,2530
4292,5,2.0,1900,1.0,7,1180,720,47.6666,1300
4293,4,2.5,3160,1.0,8,1580,1580,47.5037,1990
4294,3,2.25,2590,2.0,8,2590,0,47.3948,2590
4295,5,1.5,1310,1.5,6,1110,200,47.5545,960
4296,5,2.75,2860,2.5,8,2380,480,47.5906,2240
4297,3,1.0,1140,1.5,6,1140,0,47.6606,1690
4298,3,2.5,1800,2.0,7,1800,0,47.4006,2580
4299,3,1.0,1480,1.5,7,1480,0,47.6147,1460
4300,3,1.0,1040,1.0,7,1040,0,47.5526,1770
4301,1,2.5,1980,1.0,7,1180,800,47.4343,1980
4302,2,1.75,1780,1.0,7,890,890,47.5798,1560
4303,2,1.0,1210,1.0,8,780,430,47.6503,1860
4304,3,2.5,2290,2.0,8,2290,0,47.5476,2210
4305,4,2.25,1930,1.5,8,1540,390,47.6167,1800
4306,4,2.5,2760,2.0,9,2760,0,47.5346,2640
4307,2,1.75,1620,1.0,7,900,720,47.543,1590
4308,4,2.25,2190,1.0,7,1040,1150,47.319,1250
4309,3,2.5,3240,2.0,10,3240,0,47.5857,2970
4310,3,1.5,1400,1.0,7,1400,0,47.7711,1490
4311,3,1.0,1440,1.5,7,1440,0,47.6582,1850
4312,4,0.75,1440,1.0,6,1440,0,47.4761,1460
4313,5,2.5,2800,1.0,8,1400,1400,47.6166,2510
4314,4,1.75,1820,1.5,8,1820,0,47.6429,1870
4315,4,3.25,2980,2.0,9,2150,830,47.6352,2980
4316,4,2.0,1750,1.0,6,1750,0,47.4791,1270
4317,3,1.75,920,1.0,6,820,100,47.6386,1620
4318,3,1.75,1290,1.0,7,1290,0,47.4265,1410
4319,4,1.0,1360,1.5,6,1360,0,47.5054,1280
4320,3,2.5,1520,2.0,7,1520,0,47.7221,1540
4321,4,2.5,2760,2.0,7,2230,530,47.6877,1600
4322,4,2.0,2050,1.5,7,1210,840,47.5799,1310
4323,4,2.0,3140,1.0,8,2040,1100,47.5786,2010
4324,3,1.0,2030,1.5,7,1840,190,47.6765,2030
4325,3,1.0,1010,1.0,7,1010,0,47.3348,1490
4326,4,1.5,1980,1.0,7,1980,0,47.5606,1980
4327,3,2.5,2090,2.0,7,1670,420,47.745,2090
4328,3,3.0,2470,2.0,9,2290,180,47.641000000000005,2590
4329,3,1.5,1360,1.0,7,1360,0,47.5697,1440
4330,3,2.75,1930,1.5,7,1490,440,47.6659,2080
4331,3,2.5,2370,2.0,8,2370,0,47.5465,2230
4332,4,4.25,5550,2.0,11,5550,0,47.5305,4750
4333,4,2.5,3000,2.0,7,3000,0,47.369,2610
4334,2,2.0,1080,1.0,6,1080,0,47.6826,1530
4335,3,2.75,2170,1.5,9,1550,620,47.6389,1170
4336,2,1.0,740,1.0,6,740,0,47.688,1900
4337,4,1.75,1550,1.5,8,1550,0,47.5795,1860
4338,3,2.5,3090,2.0,9,3090,0,47.4032,3650
4339,4,2.5,2610,2.0,8,2610,0,47.345,2480
4340,2,1.5,1220,1.0,6,1220,0,47.7534,1130
4341,2,2.75,1350,2.0,8,1120,230,47.522,1410
4342,4,2.5,2370,2.0,8,2370,0,47.5633,2110
4343,4,3.0,3040,2.0,10,3040,0,47.6348,2540
4344,5,1.75,2080,1.0,7,2080,0,47.3884,1670
4345,2,1.0,870,1.0,7,870,0,47.6988,1100
4346,3,1.75,1660,1.0,7,1100,560,47.7326,1630
4347,4,2.25,2180,1.0,9,1630,550,47.317,2310
4348,4,2.5,3250,2.0,8,3250,0,47.4004,2960
4349,3,1.0,1150,1.0,7,1150,0,47.7106,1490
4350,3,1.75,1360,1.0,7,1360,0,47.4625,1580
4351,5,2.5,2810,1.0,9,1540,1270,47.5742,3190
4352,4,2.5,1780,1.0,8,1780,0,47.5931,2610
4353,3,2.5,2230,2.0,8,2230,0,47.5347,2190
4354,3,2.5,1710,2.0,8,1140,570,47.5827,1260
4355,4,1.75,1990,1.5,7,1190,800,47.5275,1240
4356,4,2.0,1630,1.0,7,1050,580,47.317,1670
4357,4,3.25,3760,1.5,9,2400,1360,47.6687,3430
4358,1,1.0,1220,1.0,6,1220,0,47.4047,2770
4359,5,3.25,3510,2.0,9,3510,0,47.6914,1970
4360,3,1.0,1610,1.0,7,1090,520,47.7391,2040
4361,3,1.0,1410,1.0,7,1410,0,47.70399999999999,1170
4362,4,1.75,1890,1.5,7,1390,500,47.6405,1890
4363,3,1.0,1250,1.0,7,1250,0,47.275,1350
4364,1,1.0,850,1.0,6,850,0,47.5427,1590
4365,1,1.0,850,1.0,6,850,0,47.5427,1590
4366,2,2.25,1190,2.0,9,1100,90,47.6666,1430
4367,2,2.25,1530,2.0,8,1280,250,47.6032,1410
4368,3,1.75,2090,1.0,7,1200,890,47.7007,1480
4369,2,1.0,1500,1.5,5,880,620,47.4857,1300
4370,3,2.0,3570,1.0,8,2070,1500,47.6413,3570
4371,1,1.0,720,1.0,6,720,0,47.6821,1320
4372,4,2.0,2990,1.0,8,2990,0,47.3068,2820
4373,3,2.0,1550,1.0,7,830,720,47.5436,1330
4374,3,2.25,2160,1.0,8,1460,700,47.7176,2160
4375,6,2.0,2610,1.0,8,1320,1290,47.622,2170
4376,2,1.0,2160,1.0,7,1360,800,47.4702,2070
4377,4,2.75,2020,1.0,7,1010,1010,47.5202,1390
4378,4,2.5,2980,2.0,10,2980,0,47.5431,3140
4379,4,2.25,2280,2.0,8,2280,0,47.5609,2320
4380,3,1.75,1260,1.0,7,1260,0,47.3586,1600
4381,2,1.75,1530,1.0,8,1020,510,47.6726,1870
4382,3,1.0,970,1.5,7,970,0,47.719,1730
4383,3,1.75,2250,1.0,8,2250,0,47.7619,2730
4384,2,1.0,870,1.0,7,870,0,47.6698,1080
4385,3,2.0,1510,1.0,7,1510,0,47.3412,1780
4386,2,1.75,1320,1.0,7,1320,0,47.3634,1570
4387,3,2.5,1800,2.0,8,1800,0,47.5747,1800
4388,3,1.0,1820,1.0,7,1120,700,47.5773,1500
4389,3,1.0,1150,1.0,6,1150,0,47.6867,1460
4390,4,1.75,2010,1.0,7,1410,600,47.5048,1610
4391,4,2.5,2180,2.0,8,2180,0,47.6186,2660
4392,4,1.0,1150,1.5,6,1150,0,47.7431,990
4393,2,1.5,1570,1.5,7,1320,250,47.6366,2140
4394,3,1.0,1600,1.5,7,1600,0,47.653,1860
4395,3,1.0,1630,1.0,7,930,700,47.5497,1630
4396,3,1.0,1350,1.0,6,1350,0,47.2217,2300
4397,3,2.25,3280,1.0,10,3280,0,47.3207,1860
4398,2,1.0,1090,1.0,7,1090,0,47.5886,1960
4399,3,1.75,1340,1.0,7,1340,0,47.4379,1950
4400,3,1.75,1340,1.0,7,1340,0,47.4379,1950
4401,2,1.0,720,1.0,6,720,0,47.5274,990
4402,2,1.0,1280,1.5,6,1280,0,47.7477,2480
4403,2,2.25,1570,2.0,9,1280,290,47.6514,1570
4404,3,1.75,1150,1.0,7,1150,0,47.6048,1650
4405,5,3.0,3850,2.0,9,2910,940,47.727,2830
4406,3,2.0,1410,1.0,7,1410,0,47.3674,1570
4407,2,1.0,740,1.0,5,740,0,47.5704,1490
4408,3,2.5,2150,1.5,6,2150,0,47.4514,1850
4409,6,4.5,5480,2.0,9,4430,1050,47.6307,2970
4410,3,2.0,1710,1.0,7,1030,680,47.3651,1390
4411,2,1.75,870,1.0,6,870,0,47.5657,1420
4412,4,1.75,2050,1.0,7,1330,720,47.6735,1290
4413,3,1.0,880,1.0,6,880,0,47.3634,940
4414,3,1.0,1160,1.0,7,1160,0,47.6818,1670
4415,3,2.5,2900,1.0,10,1490,1410,47.5708,2900
4416,4,2.5,3120,2.0,9,3120,0,47.5699,2150
4417,4,2.0,2560,1.0,7,1890,670,47.6914,1330
4418,4,2.5,3730,2.0,10,3730,0,47.5678,3200
4419,3,3.0,1790,2.0,7,1480,310,47.5421,1220
4420,3,2.25,1580,1.0,7,1200,380,47.6254,1660
4421,4,2.5,3180,2.0,9,3180,0,47.7717,2440
4422,3,1.75,1630,1.0,7,1630,0,47.757,1430
4423,5,3.25,3800,1.0,7,2490,1310,47.3862,2000
4424,2,1.0,850,1.0,6,850,0,47.4696,1280
4425,3,1.75,1560,1.0,7,1560,0,47.7769,2230
4426,3,1.0,1160,1.5,7,1160,0,47.5652,1530
4427,4,2.25,2390,2.0,8,2390,0,47.6651,2390
4428,4,3.25,2110,2.0,8,2110,0,47.6769,1780
4429,3,1.5,1340,1.0,7,1340,0,47.5752,1340
4430,3,1.0,1410,1.0,6,980,430,47.5769,1410
4431,3,1.0,1040,1.0,7,1040,0,47.4812,1660
4432,2,2.5,1720,2.0,8,1720,0,47.3728,1740
4433,3,1.75,1840,2.0,7,1270,570,47.6899,1480
4434,5,2.5,2890,2.0,9,2890,0,47.5286,2590
4435,3,2.5,2170,1.0,7,1690,480,47.3634,1420
4436,3,1.75,1440,1.0,8,1440,0,47.3503,1440
4437,3,2.5,3170,2.0,9,3170,0,47.6934,2790
4438,4,2.5,2050,1.0,7,1230,820,47.7242,1610
4439,3,1.0,1340,1.5,5,1340,0,47.7129,960
4440,4,1.75,1880,1.0,8,1880,0,47.4551,1880
4441,3,2.25,1820,1.0,7,1320,500,47.737,1780
4442,3,2.0,3120,1.0,9,1820,1300,47.5612,2770
4443,3,2.0,1170,1.0,6,1170,0,47.5276,1340
4444,4,1.0,1450,1.0,6,990,460,47.5131,1440
4445,4,1.75,2000,1.0,7,1100,900,47.3428,1720
4446,3,1.0,1030,1.0,7,830,200,47.6813,1830
4447,4,2.0,2220,1.0,7,2220,0,47.7759,2650
4448,4,2.5,1830,2.0,7,1830,0,47.3504,2080
4449,4,3.0,4480,2.0,9,4480,0,47.7711,3140
4450,3,1.5,1470,1.0,7,1470,0,47.7462,1460
4451,3,2.5,1770,2.0,7,1770,0,47.4325,1490
4452,4,3.0,2530,1.0,8,1470,1060,47.7094,1840
4453,3,1.75,1860,1.0,7,1860,0,47.3191,1860
4454,5,2.25,3210,1.5,8,3210,0,47.7632,2820
4455,4,2.25,2380,2.0,8,1530,850,47.7668,2280
4456,5,4.0,4770,2.0,12,4770,0,47.5468,4520
4457,3,2.5,1680,1.0,7,1240,440,47.423,1420
4458,4,2.5,2700,2.0,9,2700,0,47.7041,2730
4459,4,3.5,4320,2.0,10,3280,1040,47.5568,4030
4460,4,2.0,1210,1.0,7,1210,0,47.5275,1210
4461,6,2.0,2800,1.0,7,1400,1400,47.4398,1980
4462,3,2.25,1690,1.0,7,1250,440,47.2639,1670
4463,4,3.5,4420,2.0,10,3350,1070,47.5327,3440
4464,3,1.75,1640,1.0,7,1190,450,47.7197,1770
4465,3,2.5,2480,2.0,7,2480,0,47.6797,2480
4466,3,1.5,1580,1.0,8,900,680,47.6796,1580
4467,2,2.0,840,1.5,6,840,0,47.5499,1430
4468,4,2.25,2050,2.0,8,2050,0,47.3423,2330
4469,3,1.75,1300,1.0,6,650,650,47.5353,1420
4470,4,2.5,3400,2.0,9,3400,0,47.3623,3180
4471,4,2.25,2200,2.0,8,2200,0,47.3895,2200
4472,4,2.25,2560,1.0,8,1760,800,47.631,2240
4473,4,2.25,2480,1.0,8,1900,580,47.6388,2640
4474,4,1.0,1900,1.0,7,1290,610,47.4629,1950
4475,4,2.5,2000,1.5,7,1220,780,47.6902,1560
4476,5,2.5,2910,1.0,7,1690,1220,47.5803,2830
4477,3,1.0,950,1.0,6,950,0,47.575,1540
4478,2,1.0,600,1.0,5,600,0,47.4997,1060
4479,4,2.75,5470,2.0,11,3730,1740,47.5316,3620
4480,3,1.75,2600,1.0,8,1700,900,47.64,2940
4481,5,3.5,2473,2.0,7,2473,0,47.3966,2040
4482,3,1.75,1520,1.0,8,1520,0,47.3263,2060
4483,3,2.5,2830,1.0,9,1730,1100,47.5751,2040
4484,2,1.0,880,1.0,6,880,0,47.4903,1060
4485,4,1.0,1360,1.5,6,1360,0,47.6038,1010
4486,3,2.5,3110,1.0,8,1640,1470,47.6112,3650
4487,3,2.25,1860,2.0,7,1860,0,47.3879,1820
4488,3,2.25,2850,2.0,7,1900,950,47.6911,1680
4489,3,2.25,2280,1.0,7,2280,0,47.6522,2280
4490,3,1.5,2030,1.0,7,1310,720,47.2639,1330
4491,3,2.0,1760,1.0,7,960,800,47.6876,1500
4492,4,2.5,4570,2.0,11,4570,0,47.6246,4490
4493,3,3.0,3410,2.0,10,2220,1190,47.5721,3760
4494,3,1.5,1250,1.0,7,1250,0,47.6916,1030
4495,4,2.0,2000,1.5,7,1480,520,47.5532,1110
4496,2,1.0,1030,1.5,7,1030,0,47.6984,1790
4497,3,2.5,2370,2.0,9,2370,0,47.6503,1590
4498,5,1.75,1890,1.5,7,1090,800,47.6711,1610
4499,4,2.5,2007,2.0,9,2007,0,47.3301,2189
4500,4,2.0,2070,2.0,7,2070,0,47.7264,1880
4501,2,2.5,1480,3.0,7,1480,0,47.676,1390
4502,2,1.75,1160,2.0,7,1160,0,47.542,1990
4503,4,2.5,2520,2.0,8,2520,0,47.6814,1810
4504,4,2.5,2040,2.0,7,2040,0,47.3691,1730
4505,3,1.75,2580,1.0,7,1290,1290,47.5646,2280
4506,3,2.5,3140,2.0,9,2500,640,47.6383,2370
4507,3,3.25,3800,2.0,9,3800,0,47.7741,2480
4508,3,2.0,1390,1.0,8,1390,0,47.4504,1960
4509,5,1.75,2760,1.0,8,1510,1250,47.7363,1720
4510,5,1.75,1730,1.0,7,1050,680,47.3628,1350
4511,4,2.5,3300,2.0,9,3300,0,47.5072,3550
4512,3,2.25,1830,1.0,8,1400,430,47.7412,1830
4513,3,3.25,1720,2.5,9,1410,310,47.6187,1490
4514,3,1.75,1710,1.0,7,1360,350,47.5492,1490
4515,3,1.75,1700,1.0,7,1180,520,47.2874,1500
4516,3,2.5,2960,2.0,9,2960,0,47.6218,2960
4517,3,2.0,1320,1.0,6,1020,300,47.5515,2410
4518,3,3.25,2610,1.5,9,1660,950,47.6701,2110
4519,2,1.0,1010,1.0,7,1010,0,47.5311,1480
4520,3,1.75,2130,1.0,7,1720,410,47.7059,1540
4521,2,1.75,1020,1.0,6,1020,0,47.1958,1160
4522,4,2.5,2190,1.0,8,1430,760,47.5668,2580
4523,4,1.75,1970,1.0,7,1220,750,47.7489,1690
4524,3,2.25,2860,2.0,7,2860,0,47.4269,1760
4525,3,3.5,3190,2.0,10,2560,630,47.6968,3120
4526,4,3.5,3500,2.0,9,2500,1000,47.5613,2350
4527,4,2.25,3920,2.0,10,3120,800,47.5731,3400
4528,4,2.75,2190,2.0,8,2190,0,47.3535,1920
4529,4,2.0,1890,1.5,7,1490,400,47.6684,1640
4530,3,1.5,1570,1.0,7,1570,0,47.4866,1740
4531,3,2.5,3530,2.0,10,3530,0,47.5539,3220
4532,3,2.5,2230,2.0,7,2230,0,47.4386,2480
4533,2,1.0,820,1.0,7,820,0,47.55,1490
4534,5,4.5,4230,2.0,10,4230,0,47.5444,4130
4535,3,2.5,2230,2.0,7,2230,0,47.4388,2230
4536,4,3.25,3160,2.0,9,2280,880,47.536,3160
4537,4,2.5,2540,2.0,7,2540,0,47.3754,1600
4538,2,1.0,710,1.0,6,710,0,47.5155,740
4539,3,2.5,2970,1.0,9,1770,1200,47.6359,2990
4540,3,2.5,2970,1.0,9,1770,1200,47.6359,2990
4541,3,2.25,1740,1.0,7,1380,360,47.3663,1770
4542,5,2.5,3490,1.0,9,1840,1650,47.5955,2690
4543,4,1.75,1860,1.0,7,1110,750,47.3792,1570
4544,2,1.0,980,2.0,8,980,0,47.638000000000005,1180
4545,3,2.0,1290,3.0,7,1290,0,47.7161,1270
4546,2,1.0,800,1.0,6,600,200,47.6979,1720
4547,3,1.0,1480,1.0,6,940,540,47.5045,1350
4548,4,2.75,2950,1.0,8,2120,830,47.3845,2840
4549,4,1.75,1940,1.0,7,1720,220,47.3736,2000
4550,4,4.5,5770,1.0,9,3160,2610,47.677,2950
4551,6,1.75,2740,1.0,8,1370,1370,47.5062,2150
4552,4,3.25,3760,2.0,8,2740,1020,47.3862,3280
4553,3,1.5,1580,1.0,7,1140,440,47.4294,1540
4554,8,3.25,4300,2.0,8,2800,1500,47.4786,1780
4555,5,3.0,2710,2.0,7,1890,820,47.6754,2150
4556,4,2.0,1760,1.0,8,1760,0,47.6945,1950
4557,4,2.5,2155,2.0,8,2155,0,47.4204,2155
4558,5,1.5,1720,1.5,7,1520,200,47.6197,2280
4559,3,1.0,1430,1.5,7,1430,0,47.6595,1660
4560,2,1.5,1160,1.0,7,1160,0,47.5146,1500
4561,2,1.0,1570,1.5,8,1570,0,47.5256,1820
4562,4,1.75,1880,1.0,7,1010,870,47.7129,1710
4563,4,2.25,1850,1.0,7,1850,0,47.6019,1650
4564,2,1.0,990,1.5,6,990,0,47.5677,1480
4565,3,1.75,1720,1.5,7,1720,0,47.666,2000
4566,4,2.5,2370,2.0,9,2370,0,47.6336,2510
4567,4,2.5,2570,2.0,7,2570,0,47.5389,2060
4568,3,1.0,1220,1.5,6,1220,0,47.6506,1350
4569,3,1.0,1500,1.0,7,1500,0,47.6706,1500
4570,3,2.5,2680,2.0,8,2680,0,47.7557,2680
4571,4,2.25,1870,2.0,7,1870,0,47.2774,1650
4572,4,1.5,1810,1.0,7,1810,0,47.7207,2060
4573,4,2.5,2370,2.0,7,2370,0,47.3982,2090
4574,4,2.5,3220,2.0,9,3220,0,47.7547,3050
4575,4,2.5,2665,2.0,9,2665,0,47.3831,2665
4576,2,1.0,790,1.0,6,790,0,47.7644,1970
4577,5,2.5,2180,1.0,7,1200,980,47.7543,1840
4578,3,2.5,2110,1.0,7,2110,0,47.3558,1680
4579,2,1.0,1290,1.0,7,1290,0,47.6393,1940
4580,3,2.25,2210,1.0,7,1540,670,47.4911,2230
4581,3,2.25,2210,1.0,7,1540,670,47.4911,2230
4582,3,2.5,2040,1.0,8,1840,200,47.6334,1820
4583,4,3.25,3840,1.5,10,2590,1250,47.6388,3280
4584,4,2.0,1640,1.5,9,1640,0,47.6505,1900
4585,3,1.75,1720,1.0,8,1720,0,47.3731,1970
4586,3,1.75,1720,1.0,8,1720,0,47.3731,1970
4587,3,2.5,2120,2.0,8,2120,0,47.7174,1930
4588,2,1.0,940,1.0,7,940,0,47.4312,1450
4589,3,2.5,2588,2.0,8,2588,0,47.3449,2389
4590,5,3.25,3500,2.0,11,3500,0,47.5198,3500
4591,3,1.75,1690,1.0,7,1690,0,47.6745,2070
4592,3,1.5,1090,1.0,7,1090,0,47.6219,1320
4593,2,1.0,1150,1.0,7,1150,0,47.6575,1150
4594,4,2.5,2580,2.0,7,2580,0,47.4858,2160
4595,4,1.0,2220,1.5,7,1470,750,47.6854,1740
4596,3,2.25,1620,2.0,7,1620,0,47.6188,2030
4597,2,2.0,1390,1.0,8,970,420,47.7499,1940
4598,4,2.5,3420,2.0,10,3420,0,47.633,2260
4599,3,1.0,1790,1.5,7,1090,700,47.575,1360
4600,3,1.0,1790,1.5,7,1090,700,47.575,1360
4601,4,1.75,2000,1.0,7,1000,1000,47.6428,2610
4602,3,2.5,1770,1.0,8,1770,0,47.3196,2200
4603,4,1.5,1740,1.5,7,1400,340,47.7243,1600
4604,3,2.25,2390,2.0,8,1580,810,47.6339,2200
4605,4,1.75,2610,1.0,8,2610,0,47.6245,2920
4606,2,2.0,1430,1.0,7,1430,0,47.6844,1430
4607,2,1.0,670,1.0,5,670,0,47.499,2180
4608,3,1.75,1860,2.0,8,1860,0,47.5981,3030
4609,6,4.5,6040,2.0,11,4100,1940,47.5622,2010
4610,2,1.0,1010,1.0,6,1010,0,47.7461,1220
4611,4,2.5,2570,1.0,8,1710,860,47.5483,2050
4612,4,2.5,1950,2.0,8,1950,0,47.5503,1720
4613,3,1.75,1970,1.0,8,1300,670,47.6669,2500
4614,3,2.5,1980,2.0,8,1890,90,47.5456,2160
4615,2,1.0,860,1.0,6,860,0,47.7042,1450
4616,4,2.5,2320,2.0,8,2320,0,47.4449,2320
4617,4,1.0,1940,1.0,7,1080,860,47.4139,1940
4618,4,2.25,2520,2.0,8,1690,830,47.6109,1530
4619,3,2.5,2910,2.0,10,2910,0,47.5845,2420
4620,3,2.25,2670,1.0,7,1640,1030,47.4608,1970
4621,3,1.0,1060,1.0,6,760,300,47.5116,1310
4622,4,2.5,2070,1.0,8,1250,820,47.6608,2070
4623,3,1.75,1160,1.0,7,1160,0,47.7595,1940
4624,3,2.5,1610,2.0,7,1610,0,47.2827,1660
4625,4,2.25,1840,1.0,7,1390,450,47.7328,1820
4626,2,1.75,2060,1.0,7,1420,640,47.7038,1860
4627,3,2.5,2360,2.0,8,2360,0,47.3257,1860
4628,3,1.0,1060,1.0,7,1060,0,47.7317,1520
4629,4,2.0,2190,1.5,8,1990,200,47.6887,1450
4630,3,2.5,2590,2.0,9,2590,0,47.659,2600
4631,4,2.75,2580,1.0,7,1620,960,47.4475,1570
4632,2,1.0,720,1.0,6,720,0,47.4662,2300
4633,3,1.75,1390,1.0,7,1390,0,47.4559,1260
4634,3,2.5,2640,2.0,9,2640,0,47.7043,2680
4635,3,1.75,1450,1.0,8,1450,0,47.3343,2256
4636,2,1.75,1520,1.0,7,840,680,47.6876,1120
4637,4,3.5,4150,2.0,10,4150,0,47.3423,3618
4638,4,1.75,1650,1.0,7,1150,500,47.715,1390
4639,3,3.0,3730,1.5,9,2230,1500,47.4257,1940
4640,3,1.0,870,1.0,7,870,0,47.7048,1440
4641,2,1.0,900,1.0,6,900,0,47.5245,1360
4642,3,2.75,2600,2.0,9,2600,0,47.3815,2800
4643,4,2.0,1540,1.5,7,1540,0,47.6713,1790
4644,3,2.0,2290,2.0,9,2290,0,47.6517,2250
4645,4,1.75,2740,1.0,7,1440,1300,47.5112,1710
4646,4,2.5,2740,2.0,9,2740,0,47.3333,2740
4647,4,2.0,1600,1.0,7,1600,0,47.72,1660
4648,3,2.0,1850,1.0,7,950,900,47.697,1430
4649,3,1.75,2650,1.0,7,1460,1190,47.7525,1600
4650,4,2.5,3440,2.0,8,2170,1270,47.7364,3170
4651,3,1.75,1890,1.0,7,1210,680,47.4872,2040
4652,1,0.75,370,1.0,5,370,0,47.6778,1340
4653,5,3.25,3130,2.0,8,2180,950,47.5336,2410
4654,4,2.25,2290,1.0,7,1490,800,47.5114,2290
4655,5,2.25,3160,2.0,8,3160,0,47.5678,2540
4656,3,2.0,1420,1.0,7,1420,0,47.5309,2020
4657,4,1.75,2460,2.0,8,2460,0,47.7256,2760
4658,3,1.0,1340,1.5,7,1340,0,47.5272,1260
4659,4,1.0,1530,1.0,7,1030,500,47.4544,1690
4660,3,2.0,2520,1.0,8,1270,1250,47.6693,1660
4661,2,1.0,930,1.0,6,930,0,47.4822,1630
4662,3,1.0,1230,1.0,7,1230,0,47.6095,2100
4663,3,1.0,1120,1.0,7,1120,0,47.7077,1350
4664,3,1.0,1230,1.0,7,1230,0,47.539,1270
4665,2,1.0,740,1.0,6,740,0,47.2088,1160
4666,4,2.5,1770,2.0,7,1770,0,47.3483,1790
4667,4,2.5,2770,2.0,9,2770,0,47.7751,2940
4668,4,2.75,2330,2.0,9,2330,0,47.5527,2620
4669,3,2.5,1660,2.0,7,1660,0,47.3865,2240
4670,2,2.5,1730,3.5,8,1730,0,47.5594,1280
4671,3,2.25,1880,1.0,7,1280,600,47.7574,2020
4672,4,3.25,2360,2.0,8,2360,0,47.4403,1860
4673,4,3.75,3490,2.0,9,2610,880,47.6685,1940
4674,3,2.75,2370,1.0,9,1670,700,47.5648,2840
4675,4,2.5,2430,2.0,8,2430,0,47.3762,2430
4676,2,1.75,1500,1.0,7,1220,280,47.7006,1270
4677,4,2.5,2510,1.0,8,1520,990,47.3086,2210
4678,4,2.5,2420,1.0,8,1700,720,47.4871,2540
4679,2,1.0,770,1.0,6,770,0,47.7482,1010
4680,2,1.0,910,1.0,6,910,0,47.2777,1326
4681,2,1.5,820,2.0,7,820,0,47.5925,1130
4682,4,1.75,2000,1.0,7,1300,700,47.5132,1930
4683,2,1.0,1410,1.0,7,1410,0,47.4908,1540
4684,2,1.0,1410,1.0,7,1410,0,47.4908,1540
4685,3,1.5,1950,1.0,7,1010,940,47.4594,1850
4686,3,1.0,1510,1.0,7,1010,500,47.32899999999999,1290
4687,2,1.0,1210,1.0,7,1210,0,47.745,1210
4688,3,2.5,2330,1.0,10,2330,0,47.655,3320
4689,6,2.75,2410,1.0,7,1310,1100,47.4429,1310
4690,4,2.0,1470,1.0,7,1470,0,47.3702,1390
4691,3,2.5,2210,2.0,9,2210,0,47.6087,2000
4692,2,1.75,1340,3.0,8,1340,0,47.7053,1340
4693,4,2.5,2250,2.0,9,2250,0,47.4398,2480
4694,4,1.75,1870,1.0,8,1670,200,47.6435,1710
4695,4,2.5,2050,1.0,7,1300,750,47.42,1790
4696,4,1.75,3080,1.5,7,3080,0,47.498000000000005,1980
4697,2,1.0,960,1.0,6,960,0,47.4122,1020
4698,2,1.75,1090,1.0,8,1090,0,47.3794,1160
4699,4,2.75,3410,1.0,8,1710,1700,47.5718,3080
4700,2,1.0,800,1.0,7,800,0,47.5359,1010
4701,3,1.0,1750,1.0,7,1150,600,47.4596,1750
4702,3,2.25,2140,1.0,7,1470,670,47.306,2050
4703,3,2.25,1330,1.0,7,900,430,47.5102,1380
4704,3,1.0,1460,1.0,7,1460,0,47.3762,1310
4705,3,2.5,1520,2.0,7,1520,0,47.5245,1460
4706,3,2.5,3440,2.0,9,3440,0,47.3895,2710
4707,3,2.25,1990,2.0,7,1990,0,47.3822,1220
4708,3,2.25,1990,2.0,7,1990,0,47.3822,1220
4709,4,1.0,1710,1.5,7,1410,300,47.5569,1560
4710,3,2.5,1990,2.0,7,1990,0,47.383,1680
4711,4,1.75,1600,1.0,7,1210,390,47.7111,1640
4712,4,2.75,3130,2.0,9,3130,0,47.3535,2720
4713,3,2.0,1290,1.0,6,1290,0,47.5181,1960
4714,4,2.25,2070,1.0,8,1390,680,47.697,2110
4715,5,5.25,4830,2.0,9,3930,900,47.5858,2880
4716,4,2.5,2210,2.0,8,2210,0,47.35,2200
4717,5,2.0,2280,1.0,8,1140,1140,47.5672,1780
4718,4,3.25,4400,2.0,9,4400,0,47.1593,2280
4719,3,3.5,3030,2.0,8,3030,0,47.5051,2340
4720,4,2.5,2740,2.0,8,2740,0,47.74,2080
4721,3,2.0,1470,2.0,8,1000,470,47.6743,1660
4722,3,1.75,1270,2.0,7,1270,0,47.3563,1270
4723,4,1.0,1730,1.0,7,1010,720,47.4586,1369
4724,3,2.5,1370,2.0,9,1370,0,47.6375,1630
4725,2,1.0,960,1.5,5,960,0,47.63,1940
4726,3,2.25,1470,1.0,7,1160,310,47.2725,1720
4727,4,2.25,2430,1.5,8,1630,800,47.5904,2430
4728,3,2.5,2100,1.0,8,2100,0,47.2984,1330
4729,4,3.25,4040,1.0,9,4040,0,47.6155,3000
4730,4,2.25,2230,1.5,8,1810,420,47.6464,2840
4731,4,2.5,2230,2.0,7,2230,0,47.3533,1910
4732,4,2.5,2689,2.0,9,2689,0,47.3799,2665
4733,3,1.0,1620,1.5,7,1620,0,47.6888,1420
4734,4,1.75,1940,1.0,8,1940,0,47.3215,2405
4735,5,2.0,2050,1.0,6,1430,620,47.4136,1940
4736,5,2.0,2050,1.0,6,1430,620,47.4136,1940
4737,3,2.5,1520,2.0,7,1520,0,47.6801,1640
4738,5,3.5,5170,3.0,11,3520,1650,47.7561,3020
4739,4,2.5,2150,2.0,7,2150,0,47.3658,2220
4740,3,1.75,1590,1.5,6,1590,0,47.754,1800
4741,3,1.75,1990,1.0,8,1330,660,47.65,2630
4742,3,1.75,1510,1.0,7,1510,0,47.7728,1520
4743,3,2.5,2830,2.0,11,2830,0,47.7409,2830
4744,4,2.5,1900,1.0,7,1900,0,47.6856,1990
4745,4,3.5,4070,2.0,10,4070,0,47.5805,4080
4746,3,2.25,1630,1.0,8,1100,530,47.3801,1830
4747,2,2.5,1700,2.0,8,1700,0,47.6655,1700
4748,3,3.5,4660,2.0,12,4660,0,47.4418,3140
4749,3,3.75,2050,2.0,7,1550,500,47.6873,1780
4750,3,2.0,720,1.0,6,720,0,47.5483,1080
4751,3,2.5,2260,2.0,9,2260,0,47.2704,3110
4752,3,2.5,1770,2.0,9,1770,0,47.6658,2120
4753,3,2.5,3090,2.0,10,3090,0,47.588,2980
4754,4,2.75,2620,2.0,9,2620,0,47.5965,2590
4755,3,3.0,1560,3.0,8,1560,0,47.6604,1530
4756,4,1.0,1380,1.5,6,1380,0,47.3846,1430
4757,4,1.5,1350,1.0,7,1350,0,47.5807,1930
4758,3,2.5,1790,2.0,8,1790,0,47.7344,2480
4759,4,2.0,2710,1.0,7,1460,1250,47.6756,1700
4760,3,2.25,1920,1.0,7,1300,620,47.412,1500
4761,3,1.75,1440,1.0,7,1050,390,47.5329,1560
4762,4,1.75,2420,1.5,7,2420,0,47.6209,1200
4763,3,1.75,1310,1.0,7,1310,0,47.6844,1310
4764,4,1.0,1160,1.0,6,820,340,47.5175,1670
4765,3,1.0,1160,1.0,7,880,280,47.6844,1550
4766,4,2.0,1720,1.0,7,860,860,47.6765,1100
4767,5,2.5,2160,2.0,7,2160,0,47.5381,2460
4768,4,2.5,3150,2.0,9,3150,0,47.5309,3200
4769,3,1.0,1040,1.0,7,870,170,47.6461,1730
4770,3,2.0,1820,1.5,8,1720,100,47.5845,2220
4771,5,1.5,1930,1.5,8,1930,0,47.6401,2083
4772,3,2.5,3100,2.0,10,3100,0,47.6854,3340
4773,2,2.5,2390,1.0,8,2390,0,47.7243,2170
4774,3,2.0,1270,1.0,7,1270,0,47.7247,1620
4775,3,1.75,1740,1.0,7,1740,0,47.617,1350
4776,4,2.5,2130,1.0,7,1500,630,47.4068,2000
4777,4,2.5,2150,2.0,8,2150,0,47.4644,2260
4778,3,1.75,1850,1.5,6,1850,0,47.6144,2700
4779,3,1.75,1780,1.0,7,1280,500,47.4627,1780
4780,2,1.0,1630,1.0,7,830,800,47.7092,1250
4781,4,2.0,1870,1.5,7,1870,0,47.7155,1520
4782,4,2.0,1870,1.5,7,1870,0,47.7155,1520
4783,2,1.0,980,1.0,7,980,0,47.5589,1425
4784,4,2.5,2755,2.0,8,2755,0,47.7394,2820
4785,5,2.0,1430,1.5,6,1430,0,47.5192,1860
4786,5,2.0,1430,1.5,6,1430,0,47.5192,1860
4787,3,1.0,1290,1.0,7,1290,0,47.7641,1760
4788,4,2.0,1710,1.0,7,1710,0,47.5472,1550
4789,3,1.0,1040,1.0,6,1040,0,47.4206,1270
4790,3,2.0,1020,2.0,7,720,300,47.5434,1130
4791,4,2.5,3110,2.0,9,3110,0,47.4898,3080
4792,4,5.0,5310,1.0,12,3090,2220,47.5515,5220
4793,3,2.5,1380,2.0,8,1160,220,47.6148,1440
4794,3,1.75,1530,2.0,7,1530,0,47.6971,1530
4795,4,1.75,1930,1.0,9,1930,0,47.6158,2110
4796,3,1.5,2150,1.5,7,1470,680,47.5733,1750
4797,4,1.75,2300,1.5,7,2300,0,47.7308,2500
4798,3,2.25,1970,1.0,8,1180,790,47.7651,1970
4799,4,2.5,1950,2.0,7,1950,0,47.5066,1780
4800,3,2.25,1780,1.0,8,1350,430,47.7774,1860
4801,3,1.75,1790,1.0,7,1410,380,47.6989,1820
4802,3,1.75,1400,1.0,7,870,530,47.6913,1400
4803,3,1.0,950,1.0,7,950,0,47.5104,1250
4804,3,1.75,1770,1.0,8,1770,0,47.7218,1860
4805,1,1.0,710,1.0,6,710,0,47.5621,1440
4806,3,1.0,1140,1.0,7,1140,0,47.2629,1270
4807,3,2.25,3370,1.0,10,1920,1450,47.7434,3410
4808,2,1.5,901,3.0,7,901,0,47.6774,1138
4809,4,1.0,1650,1.0,7,1650,0,47.4991,1650
4810,3,2.25,1380,1.0,7,1140,240,47.3677,1640
4811,2,1.0,1230,1.0,7,1230,0,47.6797,1610
4812,3,1.75,1740,1.0,8,1500,240,47.6475,2240
4813,3,2.5,1950,2.0,8,1950,0,47.5647,1810
4814,3,1.5,1790,1.0,7,1790,0,47.6387,2080
4815,5,3.25,4240,2.0,8,3410,830,47.6472,2980
4816,3,1.0,1390,1.0,7,910,480,47.70399999999999,1320
4817,3,2.5,1700,2.0,7,1700,0,47.5418,1590
4818,4,2.5,3290,2.0,9,3290,0,47.5999,3240
4819,4,5.0,4630,2.0,11,4630,0,47.587,4630
4820,2,1.0,1070,1.0,6,1070,0,47.5224,900
4821,4,2.0,2010,2.0,7,2010,0,47.4234,2140
4822,4,2.5,2300,2.0,7,2300,0,47.5125,1770
4823,3,1.75,1990,1.0,7,1090,900,47.488,2150
4824,3,3.0,2630,1.0,9,2630,0,47.5481,2660
4825,3,1.75,1990,1.0,7,1320,670,47.5086,2130
4826,3,2.25,2070,1.0,7,1170,900,47.3431,1570
4827,3,1.0,1300,1.0,7,1300,0,47.511,1290
4828,3,2.0,1430,1.0,7,1430,0,47.4903,1200
4829,4,3.5,3380,2.0,8,3380,0,47.7741,2220
4830,3,1.0,1300,1.0,7,920,380,47.7465,1530
4831,3,1.0,1320,1.0,6,880,440,47.4697,1000
4832,3,2.5,1620,2.0,8,1620,0,47.3538,1650
4833,4,2.5,2780,2.0,8,2780,0,47.50899999999999,2450
4834,4,2.5,2070,2.0,8,2070,0,47.5284,2440
4835,3,3.25,1390,2.0,8,1140,250,47.6735,1390
4836,4,2.5,2610,2.0,8,2610,0,47.3441,2480
4837,4,1.0,1340,1.5,7,1340,0,47.6357,2040
4838,3,1.5,2240,1.0,7,1220,1020,47.6624,1570
4839,3,1.75,2270,1.0,8,2270,0,47.4474,2440
4840,5,3.0,3330,2.0,11,2610,720,47.5485,3330
4841,2,2.0,1250,1.0,7,1250,0,47.6526,1250
4842,3,2.5,3230,1.0,8,2100,1130,47.682,2760
4843,4,2.5,2220,2.0,8,2220,0,47.6956,1620
4844,3,1.0,1450,1.0,6,1050,400,47.4698,1510
4845,5,1.5,1830,1.0,7,1030,800,47.7488,2610
4846,3,2.0,2010,1.5,8,2010,0,47.2133,1840
4847,2,1.75,1820,1.0,6,910,910,47.7538,1300
4848,4,2.5,2450,1.0,8,1410,1040,47.5887,2450
4849,3,1.5,1710,2.0,7,1710,0,47.6801,1530
4850,3,2.0,1760,1.0,7,1100,660,47.3413,1730
4851,3,3.5,2440,2.0,7,1970,470,47.589,2440
4852,5,2.0,2290,1.0,7,1190,1100,47.63399999999999,1460
4853,4,2.5,2080,2.0,8,2080,0,47.4909,1630
4854,4,2.5,3520,2.0,10,3140,380,47.6429,2790
4855,2,2.5,1900,2.0,8,1900,0,47.7082,1900
4856,3,2.5,3750,2.0,9,3750,0,47.6325,3210
4857,4,2.5,2500,2.0,9,2500,0,47.6251,2770
4858,4,2.5,2480,2.0,9,2480,0,47.6835,3480
4859,3,2.0,2610,1.0,7,1310,1300,47.675,2330
4860,3,1.0,1660,1.0,7,1000,660,47.7169,1110
4861,3,1.0,2140,1.0,7,2140,0,47.5494,1630
4862,3,1.0,1570,1.0,7,1570,0,47.736,2540
4863,4,1.75,2540,1.0,8,1320,1220,47.5709,2540
4864,5,2.75,2500,1.0,7,1250,1250,47.6225,2230
4865,4,3.0,2460,1.0,8,2460,0,47.4889,1730
4866,2,1.0,750,1.0,5,750,0,47.6938,920
4867,3,2.5,3190,2.0,9,3190,0,47.7153,3190
4868,4,2.5,2181,2.0,8,2181,0,47.3503,2333
4869,3,1.75,1890,2.0,7,1890,0,47.7676,1640
4870,3,1.75,2610,1.5,8,1680,930,47.684,1330
4871,4,2.0,3090,2.5,8,3090,0,47.6851,1560
4872,3,2.5,2760,2.0,9,2760,0,47.465,2720
4873,2,1.0,1280,1.0,6,840,440,47.5532,1660
4874,3,2.0,1830,1.0,7,1230,600,47.5145,2050
4875,3,1.75,1420,1.0,7,1420,0,47.4608,1620
4876,3,1.0,1580,1.5,6,1580,0,47.6839,1580
4877,6,3.0,2960,1.0,8,1790,1170,47.6971,1280
4878,4,1.0,2210,2.0,8,2210,0,47.6105,1740
4879,4,2.25,2760,2.0,7,1790,970,47.589,1310
4880,4,2.5,2550,2.0,9,2550,0,47.7742,2460
4881,3,3.0,2440,2.0,8,1640,800,47.7152,2440
4882,4,2.75,3780,2.0,10,3780,0,47.589,3500
4883,2,1.0,890,1.0,6,890,0,47.4976,1100
4884,3,3.5,2490,2.0,8,2020,470,47.5893,2490
4885,4,2.75,2420,2.0,8,2420,0,47.2089,2270
4886,4,2.25,1720,1.0,8,1720,0,47.3192,2010
4887,4,2.5,1600,2.0,7,1600,0,47.3678,2140
4888,4,2.5,2710,2.0,9,2710,0,47.4922,2710
4889,3,1.0,1440,1.0,7,1440,0,47.2738,1440
4890,4,2.5,2980,2.0,8,2980,0,47.6872,2900
4891,3,1.75,2150,1.0,7,2150,0,47.6253,1100
4892,5,2.75,3160,2.0,10,1740,1420,47.7477,3120
4893,3,2.5,2690,2.0,7,2690,0,47.5302,2360
4894,4,1.75,1670,1.0,7,1670,0,47.7249,2590
4895,4,2.25,2140,1.0,7,1470,670,47.7213,2130
4896,5,2.75,3050,1.0,8,1800,1250,47.7249,2060
4897,5,2.75,2570,2.0,8,2570,0,47.2622,2200
4898,3,1.0,960,1.0,6,960,0,47.2891,990
4899,4,2.0,2400,2.0,6,2400,0,47.7607,1780
4900,5,2.75,1800,1.5,7,1400,400,47.6831,1400
4901,3,2.0,1710,2.0,7,1710,0,47.2917,1710
4902,4,1.75,1900,1.5,7,1360,540,47.3102,1300
4903,3,2.0,2060,1.0,7,1030,1030,47.5705,1750
4904,3,2.5,2530,1.0,8,2530,0,47.4188,2120
4905,2,1.0,730,1.0,6,730,0,47.6751,1480
4906,3,1.0,1110,1.0,7,1110,0,47.6034,1490
4907,4,2.75,2600,1.5,7,1620,980,47.6413,1960
4908,2,1.0,730,1.0,5,730,0,47.4808,860
4909,3,2.25,2440,1.0,8,2440,0,47.6629,2750
4910,2,1.0,720,1.0,6,720,0,47.5185,1390
4911,4,2.5,2100,2.0,7,2100,0,47.5947,1840
4912,3,2.25,1700,1.0,7,850,850,47.6863,2180
4913,2,2.25,2210,1.0,8,1410,800,47.697,2140
4914,3,3.5,4560,2.0,12,4560,0,47.6995,4050
4915,3,2.5,2110,2.0,9,2110,0,47.5513,2300
4916,3,2.25,2230,1.5,8,1450,780,47.5078,2060
4917,2,2.25,2160,2.0,9,2160,0,47.502,2660
4918,3,2.5,1650,2.0,7,1650,0,47.6819,1680
4919,3,2.0,1480,1.0,7,1480,0,47.3542,1680
4920,3,2.5,1800,2.0,7,1800,0,47.5401,1800
4921,4,3.75,2540,2.0,10,2540,0,47.5882,2490
4922,3,1.0,1200,1.0,6,1200,0,47.475,1960
4923,4,2.5,2640,2.0,8,2640,0,47.3551,1840
4924,4,2.5,2310,2.0,8,2310,0,47.6937,1220
4925,4,3.0,2060,1.0,8,1430,630,47.321000000000005,2250
4926,3,1.75,1380,1.5,7,1380,0,47.6109,1500
4927,3,1.0,1180,1.0,7,1180,0,47.7233,1220
4928,4,1.75,1650,1.0,7,1100,550,47.3944,1620
4929,3,2.5,2510,1.5,10,2510,0,47.6982,2810
4930,5,4.25,3530,2.0,10,3530,0,47.5894,1750
4931,3,2.25,2230,2.0,9,2230,0,47.6594,2390
4932,5,1.0,2550,2.5,9,2550,0,47.6092,1570
4933,4,2.5,2750,2.0,10,2750,0,47.5894,3370
4934,2,1.75,1720,1.0,6,860,860,47.5554,1680
4935,4,1.0,1190,1.5,7,1190,0,47.7487,1190
4936,4,2.5,1920,2.0,8,1920,0,47.2608,1940
4937,4,1.5,1460,1.0,7,1460,0,47.4698,1610
4938,2,1.0,1050,1.0,6,840,210,47.5024,1310
4939,3,2.5,3360,2.0,9,3360,0,47.7037,1810
4940,2,1.75,2170,1.0,8,2170,0,47.7542,3020
4941,3,2.25,1950,1.0,7,1200,750,47.2762,1760
4942,4,2.0,1190,1.5,7,1190,0,47.7538,1480
4943,4,2.5,2310,2.0,9,2310,0,47.7544,1980
4944,5,3.25,2800,1.5,10,1910,890,47.6421,2450
4945,3,2.5,1500,2.0,7,1500,0,47.75,1700
4946,3,1.75,2140,1.0,7,1070,1070,47.6435,1930
4947,6,2.25,3830,1.0,9,2440,1390,47.5849,2500
4948,4,1.75,2160,1.0,8,1660,500,47.6378,2430
4949,4,2.75,3410,2.0,10,3410,0,47.5559,2490
4950,3,2.0,1240,1.0,7,620,620,47.3219,1560
4951,5,3.5,2720,2.0,9,1830,890,47.6466,2920
4952,7,2.5,1940,2.0,7,1940,0,47.3191,1710
4953,3,2.25,1420,2.0,7,1420,0,47.7245,1150
4954,4,2.5,2860,2.0,9,2860,0,47.6067,2790
4955,3,1.75,1435,1.0,8,1435,0,47.4525,2030
4956,4,2.5,2630,2.0,8,2630,0,47.775,2680
4957,2,1.75,1900,1.0,7,1100,800,47.5121,1650
4958,4,3.5,3500,2.0,10,3500,0,47.5641,2630
4959,3,1.75,2130,1.0,7,1090,1040,47.4593,1590
4960,3,2.5,950,2.0,8,950,0,47.6226,1230
4961,3,3.25,3990,2.0,9,2870,1120,47.5744,3640
4962,4,3.25,3960,2.0,11,3960,0,47.5211,3870
4963,3,2.5,1940,1.0,7,1420,520,47.3385,1810
4964,6,3.5,4430,2.0,9,3000,1430,47.5156,2730
4965,4,2.25,3070,2.0,8,3070,0,47.7316,1880
4966,4,2.75,3260,2.0,9,3260,0,47.5414,3180
4967,3,2.0,1130,1.0,6,1130,0,47.4779,1270
4968,2,1.0,1040,1.0,7,1040,0,47.6558,1890
4969,4,4.0,3680,2.0,10,3680,0,47.6193,3200
4970,5,3.5,2660,2.0,8,1980,680,47.2631,2220
4971,4,3.0,2150,2.0,8,2150,0,47.6335,1590
4972,1,1.0,1000,1.0,7,1000,0,47.5007,1090
4973,3,1.75,1790,1.0,7,1360,430,47.7362,1910
4974,2,1.0,890,1.0,6,890,0,47.691,990
4975,4,3.25,4240,2.0,10,4240,0,47.6526,3390
4976,3,2.25,2880,1.0,9,1710,1170,47.6938,2920
4977,3,1.5,1660,1.5,7,1660,0,47.6409,1640
4978,3,1.0,1150,1.0,7,1150,0,47.6755,1550
4979,4,2.5,2640,2.0,8,2640,0,47.6038,2460
4980,5,2.0,2330,1.0,7,1310,1020,47.6955,1930
4981,5,1.75,1890,1.0,7,1890,0,47.7391,2350
4982,2,1.75,1060,2.0,7,960,100,47.5999,1170
4983,2,2.0,1600,1.0,7,1600,0,47.6968,1600
4984,1,1.0,640,1.0,6,640,0,47.5551,1250
4985,6,4.25,5860,2.0,10,4150,1710,47.5382,5790
4986,4,2.5,2350,2.0,8,2350,0,47.3507,2190
4987,3,1.0,1250,1.5,6,970,280,47.6757,1830
4988,3,2.0,2260,1.0,8,1780,480,47.6457,2250
4989,5,1.75,1750,1.0,7,1750,0,47.4007,1430
4990,2,1.0,1570,1.5,8,1570,0,47.5955,1760
4991,3,3.0,1820,3.0,8,1540,280,47.6482,1720
4992,3,1.0,1480,1.0,8,1480,0,47.5179,2250
4993,4,1.75,2520,1.0,8,1680,840,47.7721,2340
4994,2,1.0,770,1.0,6,770,0,47.5075,1110
4995,3,1.0,1010,1.0,6,1010,0,47.4905,1010
4996,2,1.0,1160,1.0,7,1160,0,47.7364,1320
4997,4,2.5,1850,2.0,7,1850,0,47.4031,1940
4998,3,2.25,2120,1.0,8,2120,0,47.29600000000001,1400
4999,5,2.5,2620,1.0,7,1400,1220,47.72,2390
5000,3,1.0,1060,1.0,7,1060,0,47.6855,1630
5001,4,1.75,2380,2.0,7,1820,560,47.6656,2190
5002,5,3.0,3045,2.0,8,3045,0,47.4386,3045
5003,2,1.0,740,1.0,5,740,0,47.4217,1230
5004,2,1.0,920,1.0,7,920,0,47.5015,2330
5005,3,1.0,1260,1.5,7,1260,0,47.644,1700
5006,3,1.75,1700,1.0,7,1200,500,47.3637,1900
5007,2,1.0,770,1.0,6,770,0,47.7467,880
5008,3,2.0,2420,1.0,7,1420,1000,47.4322,1546
5009,2,1.0,710,2.0,7,710,0,47.6414,1370
5010,3,2.75,2760,1.0,8,1690,1070,47.5402,2610
5011,3,1.75,1840,1.0,8,1370,470,47.6729,1920
5012,1,1.0,560,1.0,4,560,0,47.5335,980
5013,3,1.0,1140,1.0,8,1140,0,47.709,2080
5014,3,1.5,1890,1.5,7,1890,0,47.6662,1620
5015,4,2.75,3460,2.0,8,3460,0,47.2046,1500
5016,4,2.5,2680,2.0,9,2680,0,47.4395,2580
5017,4,2.25,1870,2.0,7,1870,0,47.3844,2380
5018,4,2.75,2310,1.0,8,1790,520,47.5473,2230
5019,3,1.0,1340,1.0,7,1340,0,47.4916,2090
5020,3,2.25,2390,1.0,10,1980,410,47.6515,3720
5021,2,1.0,900,1.0,6,900,0,47.4217,1240
5022,3,2.5,1740,1.0,8,1130,610,47.3948,2000
5023,3,3.0,3230,2.0,10,2220,1010,47.562,2330
5024,4,1.0,1660,1.5,7,1660,0,47.6755,1810
5025,3,1.75,1140,1.0,7,1140,0,47.7027,1490
5026,4,1.75,2630,1.0,9,2630,0,47.5459,2690
5027,5,2.5,1960,1.0,7,1360,600,47.4368,1900
5028,5,2.5,4250,1.0,11,2490,1760,47.6377,3620
5029,3,2.25,1950,1.0,8,1950,0,47.3127,1950
5030,3,2.25,2060,1.0,9,1610,450,47.5402,2930
5031,4,2.25,2860,2.0,10,2130,730,47.6395,2700
5032,2,1.5,1030,3.0,8,1030,0,47.6975,1020
5033,4,2.5,2460,2.0,8,2460,0,47.6041,2460
5034,6,3.25,2820,2.0,8,1930,890,47.6688,2820
5035,4,2.5,3240,1.0,9,1860,1380,47.6298,3150
5036,3,1.75,1570,1.0,7,980,590,47.7166,2420
5037,2,1.0,910,1.0,7,910,0,47.4297,1410
5038,3,2.0,1760,1.0,7,1760,0,47.4783,1190
5039,5,2.0,2800,1.0,8,1400,1400,47.6719,1760
5040,5,2.0,2360,1.0,7,2360,0,47.3299,1860
5041,3,2.5,1980,2.0,8,1980,0,47.4856,2070
5042,5,3.5,2950,2.0,9,2350,600,47.5339,2950
5043,5,3.0,3640,2.0,10,3640,0,47.5502,3330
5044,5,2.25,2890,2.0,9,2890,0,47.6295,2570
5045,3,2.25,2060,1.0,8,1340,720,47.7712,2320
5046,5,2.5,3190,2.0,8,3190,0,47.5104,2480
5047,2,1.5,1270,2.0,8,1000,270,47.5581,1270
5048,3,2.25,2730,2.0,9,2730,0,47.7704,2700
5049,3,2.25,1970,1.0,8,1380,590,47.3821,1970
5050,3,2.75,3200,2.0,9,3200,0,47.5884,3020
5051,3,1.0,1060,1.0,7,1060,0,47.7355,1570
5052,3,3.25,1740,2.0,8,1360,380,47.558,1130
5053,3,2.5,2460,2.0,7,2460,0,47.5415,2060
5054,4,2.75,2470,1.0,8,1280,1190,47.2504,2200
5055,3,2.5,3150,2.0,10,3150,0,47.447,2920
5056,2,1.75,2050,1.0,8,2050,0,47.6209,2980
5057,2,1.0,1210,1.5,7,1210,0,47.5322,1400
5058,3,1.75,1880,1.0,7,940,940,47.7362,1880
5059,2,1.75,860,1.0,7,860,0,47.6901,1420
5060,4,2.75,3340,2.0,9,3340,0,47.549,3230
5061,1,1.0,1090,1.0,6,1090,0,47.6928,1870
5062,4,1.75,2470,2.0,8,2470,0,47.4421,1470
5063,4,1.0,1040,1.5,6,1040,0,47.6945,1310
5064,4,2.5,3690,2.0,11,3690,0,47.5699,3370
5065,3,1.75,1960,1.0,7,1400,560,47.739,2010
5066,3,2.0,1430,1.0,7,1430,0,47.2671,1610
5067,2,1.0,880,1.0,6,880,0,47.4885,1220
5068,2,1.0,1360,1.0,6,680,680,47.7689,1360
5069,3,2.0,2000,1.0,8,1430,570,47.6976,1530
5070,3,1.5,1810,1.0,8,1810,0,47.7617,2920
5071,3,2.75,2230,1.0,8,1460,770,47.5791,2200
5072,3,2.75,1820,1.0,9,1820,0,47.5705,2540
5073,4,2.5,2710,2.0,9,2710,0,47.434,2710
5074,3,1.0,1040,1.0,6,1040,0,47.32899999999999,1000
5075,4,2.25,2810,1.0,8,1610,1200,47.4437,2400
5076,4,2.5,2000,2.0,8,2000,0,47.7695,1790
5077,3,2.5,2010,2.0,7,2010,0,47.1956,1550
5078,3,1.5,1370,1.0,7,1370,0,47.7153,1370
5079,4,3.5,4640,2.0,10,3210,1430,47.5524,3810
5080,3,2.0,1650,2.0,8,1650,0,47.7053,1730
5081,4,1.75,1590,2.0,7,1590,0,47.7358,1610
5082,4,2.75,2440,1.0,8,1440,1000,47.7456,2030
5083,4,1.75,2190,1.0,8,2190,0,47.7108,2040
5084,3,1.75,1490,1.0,7,1490,0,47.4806,1340
5085,3,2.25,2530,2.0,9,2530,0,47.7221,3110
5086,2,1.0,1770,1.5,6,1520,250,47.6926,1060
5087,4,2.5,3190,2.0,10,3190,0,47.3555,3400
5088,2,2.5,1140,3.0,8,1140,0,47.6713,1290
5089,3,1.75,1540,2.0,6,1540,0,47.4451,1540
5090,4,2.5,2500,2.0,8,2500,0,47.4124,2360
5091,3,1.75,1470,1.0,7,1030,440,47.7325,1100
5092,3,2.5,2380,2.0,8,2380,0,47.5255,2450
5093,3,2.5,2860,2.0,8,2860,0,47.5336,2650
5094,2,1.0,1010,1.0,6,1010,0,47.3759,980
5095,6,5.25,2860,2.0,7,2860,0,47.303,1390
5096,4,3.5,4285,2.0,10,3485,800,47.6434,2960
5097,2,1.0,1180,1.0,6,1180,0,47.7475,1180
5098,2,1.0,840,1.0,6,840,0,47.484,1480
5099,2,1.0,840,1.0,6,840,0,47.484,1480
5100,3,2.0,1830,1.0,8,1830,0,47.3066,2490
5101,3,1.5,1800,1.0,7,1200,600,47.6858,1580
5102,3,1.75,2440,1.0,7,1220,1220,47.4118,1650
5103,3,2.5,2910,2.0,10,2910,0,47.4602,2680
5104,3,1.0,1270,1.0,7,1270,0,47.7279,1480
5105,3,2.25,1580,1.0,7,1180,400,47.6365,1580
5106,1,1.0,820,1.0,8,760,60,47.5472,1770
5107,2,1.0,1160,1.0,6,580,580,47.3537,1160
5108,4,2.25,2300,1.0,7,1280,1020,47.4576,1640
5109,3,1.0,1130,1.0,6,1130,0,47.4952,1190
5110,2,1.25,1230,2.0,9,1050,180,47.6193,1100
5111,1,0.75,850,1.0,6,850,0,47.7654,900
5112,3,2.5,1500,1.0,7,1000,500,47.7236,1840
5113,9,4.0,4620,2.5,11,3870,750,47.6684,2710
5114,5,2.5,3160,1.0,7,1580,1580,47.5735,2440
5115,3,1.75,2070,1.0,7,2070,0,47.2853,1820
5116,3,2.25,1790,1.0,7,1220,570,47.7184,2040
5117,4,2.5,2070,1.0,7,1230,840,47.6958,1770
5118,4,2.25,2170,1.0,8,1420,750,47.6219,2390
5119,2,2.0,1120,2.0,8,760,360,47.5788,1120
5120,4,3.5,4740,2.0,11,4740,0,47.6779,2120
5121,2,2.25,1280,2.0,7,1280,0,47.5939,1250
5122,1,1.5,1048,1.0,7,1048,0,47.4759,950
5123,4,2.5,2380,2.0,8,2380,0,47.5382,1370
5124,2,1.0,850,1.0,7,850,0,47.6926,980
5125,3,2.5,1930,2.0,8,1930,0,47.4938,2290
5126,4,2.5,1990,2.0,7,1990,0,47.3125,1500
5127,3,2.5,2550,2.0,9,2550,0,47.739,2550
5128,3,1.5,2120,1.0,8,1220,900,47.5658,1620
5129,4,3.5,2840,2.0,10,1920,920,47.5543,1300
5130,4,2.5,2080,1.0,7,1680,400,47.5107,1270
5131,2,1.0,1250,1.0,7,1250,0,47.5318,1180
5132,2,1.0,1370,1.0,6,1370,0,47.4224,1330
5133,3,1.75,1690,1.0,8,1690,0,47.5247,1270
5134,4,3.0,2840,1.5,8,2060,780,47.5683,1840
5135,2,2.5,2000,2.0,9,2000,0,47.7056,2510
5136,4,2.25,3060,2.0,8,3060,0,47.3397,2090
5137,5,2.25,2780,2.0,9,2780,0,47.6134,2740
5138,3,2.5,1270,3.0,8,1270,0,47.6697,1320
5139,3,1.75,1480,1.0,7,740,740,47.5718,1600
5140,5,2.5,3210,1.0,8,1830,1380,47.6205,2450
5141,4,2.25,2940,2.0,9,2940,0,47.6214,3410
5142,3,2.0,1190,1.0,7,1190,0,47.31399999999999,1700
5143,3,2.0,1030,1.0,7,1030,0,47.3463,1300
5144,2,1.5,1140,1.0,7,1140,0,47.7354,2140
5145,4,2.5,2870,2.0,9,2870,0,47.7568,2700
5146,4,1.75,2300,1.0,9,1960,340,47.6331,2840
5147,4,2.5,2740,2.0,8,2740,0,47.6315,2310
5148,5,2.25,3440,2.0,9,3440,0,47.6127,2822
5149,3,2.5,1590,2.0,7,1110,480,47.6855,1590
5150,3,2.25,1810,2.0,8,1810,0,47.6882,1760
5151,4,2.5,2160,2.0,8,2160,0,47.4111,2020
5152,3,2.5,2100,2.0,7,1500,600,47.614,1750
5153,5,5.25,5090,2.0,12,5090,0,47.6297,3830
5154,3,2.25,2090,1.0,7,1280,810,47.3951,1800
5155,5,3.0,3520,2.0,8,2100,1420,47.4658,3000
5156,4,1.5,2340,2.0,8,2100,240,47.6065,2320
5157,4,2.25,1770,2.0,7,1770,0,47.4192,1770
5158,4,1.75,2200,1.0,7,1100,1100,47.7481,1940
5159,4,2.25,2250,2.0,9,2010,240,47.643,1910
5160,3,1.5,1580,1.0,7,1580,0,47.4423,1650
5161,3,2.5,2140,2.0,8,2140,0,47.3289,2180
5162,4,1.75,1770,1.0,8,1770,0,47.4265,2030
5163,3,1.75,3320,1.5,8,2260,1060,47.2407,2960
5164,3,2.0,1640,1.0,7,910,730,47.6546,1670
5165,3,1.0,1240,1.0,7,1240,0,47.6775,1240
5166,4,2.5,3570,2.0,10,3570,0,47.5617,3510
5167,4,2.5,2650,2.0,9,2650,0,47.3515,2760
5168,4,2.5,3500,2.0,10,3500,0,47.5533,3820
5169,3,1.75,2180,2.0,9,2180,0,47.4831,2300
5170,5,2.5,2870,2.0,9,2870,0,47.5463,2870
5171,2,1.0,1500,1.0,8,1500,0,47.4727,1700
5172,3,2.5,2120,1.0,8,1230,890,47.5621,2690
5173,3,1.5,1590,1.0,7,1080,510,47.73,1590
5174,3,2.0,1550,1.5,8,1550,0,47.606,2400
5175,3,2.25,1740,1.0,8,1740,0,47.5138,2100
5176,3,2.5,1710,2.0,7,1710,0,47.2778,1720
5177,4,2.5,1840,2.0,7,1840,0,47.2649,1430
5178,3,2.5,1480,2.0,7,1480,0,47.3293,1810
5179,4,2.0,1590,1.0,7,1590,0,47.6406,2370
5180,4,1.5,1690,1.0,7,1290,400,47.7438,1780
5181,3,1.5,1690,1.0,7,1430,260,47.356,1930
5182,4,1.75,2120,1.0,7,1060,1060,47.7172,1530
5183,3,1.0,1300,1.0,7,1300,0,47.64,1600
5184,4,2.75,2710,2.0,9,2710,0,47.4634,2390
5185,3,1.0,1120,1.0,6,1120,0,47.2051,1250
5186,3,1.5,1000,1.0,7,1000,0,47.5643,1520
5187,3,1.75,1350,1.0,8,1350,0,47.3334,1520
5188,4,2.25,3070,2.0,8,2740,330,47.7638,2580
5189,2,1.75,1990,1.0,7,1090,900,47.6889,1270
5190,2,1.0,930,1.0,6,930,0,47.5699,2800
5191,4,2.25,2170,1.0,8,1270,900,47.4394,2080
5192,4,2.5,2100,2.0,8,2100,0,47.3901,2100
5193,6,3.25,3560,2.0,9,3560,0,47.7602,3560
5194,3,2.5,2160,2.0,8,2160,0,47.4166,1990
5195,2,1.0,860,1.0,6,860,0,47.7206,1270
5196,5,2.75,2880,2.0,8,2880,0,47.7048,2940
5197,4,2.75,2610,3.0,8,1910,700,47.6901,1470
5198,3,1.0,1150,1.0,6,1150,0,47.6614,1490
5199,6,1.5,2550,1.0,8,1750,800,47.3222,2010
5200,4,2.5,2480,2.0,7,2480,0,47.4998,2950
5201,4,1.75,1920,2.0,7,1920,0,47.5381,1310
5202,3,2.75,2200,1.0,8,1570,630,47.3438,2680
5203,3,1.0,910,1.0,7,910,0,47.3337,1530
5204,4,2.25,1964,2.0,9,1964,0,47.3594,1757
5205,2,1.0,770,1.0,7,770,0,47.762,1060
5206,4,2.5,3210,2.0,10,3210,0,47.6073,3280
5207,3,2.5,1670,2.0,8,1670,0,47.531000000000006,1670
5208,2,1.0,710,1.0,6,710,0,47.4811,1230
5209,4,2.5,1660,2.0,7,1660,0,47.3635,1580
5210,3,1.5,1280,1.0,7,850,430,47.5509,1280
5211,3,2.0,1860,1.5,7,1110,750,47.6102,1680
5212,4,2.5,3480,1.0,9,1980,1500,47.3816,3480
5213,2,1.0,700,1.0,5,700,0,47.4934,960
5214,3,2.0,1640,1.0,7,1040,600,47.3661,1640
5215,3,2.5,2720,2.0,8,2720,0,47.4954,1950
5216,3,1.0,1660,1.0,7,1660,0,47.708,2020
5217,6,3.0,3560,1.0,7,1780,1780,47.5282,3040
5218,4,1.75,1880,1.5,7,1090,790,47.6635,1390
5219,4,2.5,2940,2.0,9,2940,0,47.5333,2980
5220,4,3.5,3930,2.0,10,3930,0,47.7497,2860
5221,5,2.5,3220,2.0,8,3220,0,47.5957,2550
5222,4,2.25,2140,1.0,7,1550,590,47.7271,2350
5223,2,1.0,710,1.0,6,710,0,47.4939,1320
5224,3,2.25,2350,1.0,7,1020,1330,47.6809,1570
5225,3,1.0,1250,1.0,6,1250,0,47.4235,1820
5226,4,3.25,3200,2.0,9,3200,0,47.5886,3120
5227,3,2.75,2590,2.0,10,2590,0,47.5527,2850
5228,3,2.75,2590,2.0,10,2590,0,47.5527,2850
5229,5,2.5,2700,1.0,8,1950,750,47.6078,2550
5230,3,1.75,1670,1.0,8,1670,0,47.595,2410
5231,5,2.75,3090,1.0,9,3090,0,47.6232,2970
5232,4,2.0,1440,1.0,5,1440,0,47.5049,1500
5233,3,2.5,2820,1.0,9,1780,1040,47.7691,2300
5234,3,2.5,1509,3.0,8,1509,0,47.7047,1509
5235,3,1.0,1160,1.0,6,1160,0,47.7024,1800
5236,3,2.5,1540,3.0,8,1390,150,47.6457,1680
5237,3,2.5,2340,2.0,7,2340,0,47.3608,1850
5238,2,1.5,1150,2.0,7,1150,0,47.7248,1400
5239,4,2.75,3260,1.0,10,2170,1090,47.6245,3480
5240,4,1.75,1900,1.0,6,1900,0,47.289,1530
5241,3,1.0,1340,1.0,6,1340,0,47.3224,1320
5242,3,2.75,3170,1.0,9,3170,0,47.6611,3920
5243,4,1.0,1370,1.5,6,1370,0,47.5046,1280
5244,2,2.0,1030,1.0,6,1030,0,47.4905,1790
5245,3,2.25,1820,1.0,7,1320,500,47.5849,1780
5246,3,2.25,2180,2.0,8,2180,0,47.6723,2060
5247,3,3.5,2480,2.0,8,2480,0,47.6083,2380
5248,4,2.5,3630,2.0,10,3630,0,47.3623,3370
5249,5,2.5,3160,2.0,9,3160,0,47.5362,3670
5250,4,2.25,2420,2.0,8,2420,0,47.4663,2410
5251,4,2.5,3290,2.0,10,3290,0,47.7048,3290
5252,3,1.0,1430,1.0,6,1080,350,47.6724,1630
5253,4,1.75,1840,1.0,7,1090,750,47.4002,1840
5254,2,1.0,720,1.0,6,720,0,47.7598,952
5255,3,1.75,1230,1.0,7,1230,0,47.4528,1420
5256,2,1.0,740,1.0,6,740,0,47.5245,1080
5257,3,4.25,5150,2.5,11,4170,980,47.6288,4270
5258,4,4.5,3420,3.0,9,3420,0,47.6875,1360
5259,4,2.25,1970,1.5,7,1500,470,47.6725,1980
5260,1,1.0,1390,1.0,6,1390,0,47.7652,1620
5261,4,2.5,2250,2.0,8,2250,0,47.5123,1980
5262,2,1.0,990,1.0,7,990,0,47.6589,1560
5263,3,1.5,1060,1.0,7,1060,0,47.5532,1060
5264,4,2.75,2470,1.0,9,1570,900,47.6586,1620
5265,3,1.75,1010,1.0,7,1010,0,47.375,1010
5266,2,1.0,700,1.0,6,700,0,47.7172,990
5267,2,1.75,1810,2.0,8,1810,0,47.7177,1350
5268,3,2.75,2440,2.0,8,1840,600,47.5453,2440
5269,3,1.75,2050,1.5,8,1300,750,47.6374,2220
5270,3,1.0,920,1.0,6,920,0,47.3665,920
5271,3,1.0,1660,1.0,7,960,700,47.3212,1370
5272,3,2.25,1470,2.0,8,1470,0,47.5478,1380
5273,5,3.5,3370,2.0,9,2650,720,47.5584,3330
5274,2,1.5,1340,1.5,7,1340,0,47.6358,1340
5275,3,1.75,1310,1.0,7,1310,0,47.4051,1440
5276,4,2.5,2650,1.0,8,1680,970,47.5535,2650
5277,3,2.75,1890,2.0,8,1890,0,47.5336,1890
5278,4,3.0,2580,2.0,8,2580,0,47.4286,2010
5279,4,2.75,3500,2.0,9,3500,0,47.6818,3920
5280,3,1.75,1530,2.0,8,1530,0,47.5239,2140
5281,4,1.0,1480,1.5,7,1480,0,47.5282,2380
5282,4,3.0,3370,2.0,10,3370,0,47.733,3370
5283,2,1.0,2240,1.0,7,1120,1120,47.5631,1390
5284,3,2.5,1970,2.0,8,1970,0,47.6345,1850
5285,2,1.0,590,1.5,5,590,0,47.3364,2020
5286,4,2.5,2810,2.0,10,2810,0,47.5943,3540
5287,4,1.75,2190,2.0,8,2190,0,47.3003,2410
5288,4,3.0,2180,2.0,7,2180,0,47.5338,1500
5289,4,2.25,2160,1.0,7,1460,700,47.7595,1880
5290,4,2.25,2160,1.0,7,1460,700,47.7595,1880
5291,2,1.0,1410,1.5,8,1410,0,47.6872,1410
5292,2,1.5,1430,3.0,7,1430,0,47.7222,1430
5293,3,1.0,1030,1.0,7,880,150,47.7192,1610
5294,3,1.0,1510,1.0,7,1510,0,47.3331,1180
5295,3,1.75,2910,1.5,8,2910,0,47.5747,2590
5296,3,1.5,1810,1.0,7,950,860,47.3585,1790
5297,3,1.0,940,1.0,7,940,0,47.6889,1430
5298,5,3.25,3890,1.0,10,2260,1630,47.6312,3450
5299,3,1.0,1220,1.0,6,1220,0,47.496,1140
5300,2,1.0,720,1.0,6,720,0,47.4488,1100
5301,4,2.0,2040,2.0,7,2040,0,47.6689,2560
5302,3,1.0,1570,1.0,7,1070,500,47.3943,2030
5303,4,2.5,3180,2.0,9,3180,0,47.5172,3020
5304,3,1.5,1390,2.0,7,1390,0,47.4704,1390
5305,2,2.5,1785,2.0,7,1595,190,47.5959,1780
5306,2,1.0,840,1.0,7,840,0,47.5319,1120
5307,2,1.0,770,1.0,7,770,0,47.6358,1440
5308,4,1.75,1814,1.0,7,944,870,47.684,1290
5309,5,3.0,2750,1.0,7,1730,1020,47.5878,2520
5310,3,2.5,1950,2.0,7,1950,0,47.343,1540
5311,5,4.0,4510,2.0,10,4510,0,47.5309,3510
5312,3,1.75,1720,1.0,7,1420,300,47.7062,1380
5313,2,3.25,1400,3.0,8,1400,0,47.6534,1400
5314,5,4.25,3920,2.0,7,3920,0,47.5766,1400
5315,3,2.5,2330,2.0,9,2330,0,47.5467,2460
5316,3,2.0,1310,1.0,7,780,530,47.6911,1460
5317,3,1.75,2340,1.0,8,2340,0,47.6989,3260
5318,3,2.5,1430,1.0,7,1430,0,47.7012,1470
5319,4,2.5,2340,1.0,8,1610,730,47.3363,2070
5320,3,1.0,1290,1.0,7,1290,0,47.4743,1410
5321,6,2.0,2780,2.5,7,2780,0,47.3738,2120
5322,3,2.0,2090,1.5,8,1530,560,47.6433,2010
5323,3,2.5,2300,2.0,8,2300,0,47.7326,2010
5324,3,3.0,4560,2.0,10,4040,520,47.7024,2620
5325,4,2.0,2530,1.5,8,1910,620,47.5778,1310
5326,4,2.5,3350,1.0,10,1760,1590,47.5507,4240
5327,2,1.0,1550,1.5,8,1550,0,47.6368,1800
5328,3,1.0,920,1.0,7,920,0,47.2958,1188
5329,2,1.0,950,1.0,6,950,0,47.5864,1420
5330,4,2.5,2690,2.0,9,2690,0,47.3314,2520
5331,3,1.5,1070,1.0,6,1070,0,47.5335,1020
5332,4,1.75,1730,1.0,7,980,750,47.5979,2100
5333,4,2.0,1770,2.0,7,1630,140,47.5563,1640
5334,5,2.75,3030,2.0,8,3030,0,47.6186,2500
5335,4,1.5,1540,2.0,7,1540,0,47.734,1550
5336,4,2.75,2240,2.0,7,1380,860,47.7427,1550
5337,4,2.25,3160,1.0,10,3160,0,47.7337,3530
5338,3,2.5,2100,2.0,8,2100,0,47.7242,2100
5339,4,2.5,2600,2.0,9,2600,0,47.5283,2950
5340,3,2.0,2850,1.0,8,2340,510,47.3378,2860
5341,2,1.75,1560,1.0,7,880,680,47.6419,2060
5342,5,3.0,3480,2.0,8,3480,0,47.5757,3030
5343,4,2.5,1630,2.0,7,1630,0,47.3546,1830
5344,3,2.25,1820,1.0,7,1240,580,47.6157,1820
5345,3,2.0,2900,1.0,8,1520,1380,47.5789,1810
5346,2,1.0,1140,1.0,6,1140,0,47.2093,1730
5347,4,2.5,3450,2.0,9,3450,0,47.7625,3030
5348,4,3.75,3370,2.0,9,3370,0,47.7063,3530
5349,4,1.0,1940,1.5,7,1940,0,47.7188,2170
5350,4,2.0,2520,1.0,7,1600,920,47.7263,2040
5351,2,1.0,800,1.0,6,800,0,47.6953,1020
5352,4,2.5,3010,2.0,10,3010,0,47.578,2840
5353,3,1.75,2340,2.0,9,2340,0,47.6451,2830
5354,3,2.0,1780,1.0,8,1780,0,47.5062,2470
5355,2,1.75,1720,1.0,7,860,860,47.68600000000001,1360
5356,5,4.25,5040,2.0,11,5040,0,47.5282,4300
5357,5,2.75,3500,2.0,9,2950,550,47.5527,1450
5358,4,2.75,3600,2.0,9,2610,990,47.6487,1590
5359,4,2.5,2340,2.0,7,2340,0,47.5117,1310
5360,3,1.0,1310,1.0,7,1310,0,47.6019,1280
5361,3,2.5,2050,2.0,8,2050,0,47.7746,2320
5362,2,1.5,1260,1.5,7,1260,0,47.6792,2140
5363,2,1.0,1320,1.5,7,1320,0,47.6729,1360
5364,3,1.75,1350,1.5,7,1350,0,47.6581,1880
5365,3,1.0,1580,1.0,7,1040,540,47.3542,1480
5366,4,1.0,1690,1.5,7,1690,0,47.663,1970
5367,2,1.0,700,1.0,6,700,0,47.6958,1160
5368,3,3.0,2060,2.0,8,2060,0,47.637,1760
5369,4,2.25,2000,2.0,8,2000,0,47.5584,2080
5370,2,2.0,1040,1.0,6,1040,0,47.7362,2300
5371,3,3.25,2970,2.0,9,2040,930,47.5353,2970
5372,3,2.0,2870,1.0,9,1350,1520,47.4834,2870
5373,3,2.0,2560,1.0,8,1330,1230,47.648,2390
5374,3,1.5,1350,1.0,6,1350,0,47.4565,1350
5375,4,2.75,3210,1.0,7,1810,1400,47.7743,2450
5376,5,1.75,3240,2.0,7,2690,550,47.5529,2650
5377,4,2.5,3560,2.0,10,3560,0,47.6903,1660
5378,3,2.25,1520,2.0,7,1520,0,47.3492,1410
5379,4,1.75,1360,1.5,7,1360,0,47.556,1320
5380,3,2.5,2000,2.0,7,2000,0,47.3516,1750
5381,3,3.0,2500,2.0,8,2500,0,47.4022,2290
5382,2,1.0,830,1.0,6,830,0,47.7366,1180
5383,5,2.75,3630,2.0,11,3630,0,47.4243,3620
5384,3,2.5,2650,2.0,9,2650,0,47.3185,2920
5385,3,2.0,1160,1.0,5,580,580,47.585,2961
5386,3,2.5,1960,2.0,8,1960,0,47.4904,1690
5387,3,2.25,2030,1.0,8,1500,530,47.534,2030
5388,5,3.0,2200,1.0,7,1440,760,47.7033,1960
5389,4,2.75,3030,1.0,8,1680,1350,47.401,2060
5390,3,2.5,3200,1.0,10,3200,0,47.7614,3200
5391,4,1.5,1580,1.0,7,1030,550,47.5984,1520
5392,2,1.0,1640,1.0,7,1040,600,47.6426,1780
5393,2,1.75,1650,1.0,7,950,700,47.5622,1060
5394,3,2.25,1780,2.0,7,1780,0,47.3593,1510
5395,3,1.0,1410,1.0,8,1410,0,47.4969,1500
5396,3,1.0,870,1.0,6,870,0,47.3701,1020
5397,4,2.5,3170,1.0,9,1910,1260,47.7648,2590
5398,3,1.0,1270,1.0,7,1270,0,47.6703,1560
5399,4,1.75,2860,1.0,8,1710,1150,47.7605,2460
5400,4,1.75,2860,1.0,8,1710,1150,47.7605,2460
5401,5,2.0,2220,1.5,7,1390,830,47.5822,1600
5402,3,2.75,3370,1.5,7,2310,1060,47.5373,1720
5403,2,1.0,940,1.0,5,940,0,47.4206,1200
5404,3,1.0,1340,1.0,7,1340,0,47.7148,1340
5405,3,1.5,1440,1.0,7,1440,0,47.3715,1720
5406,3,2.5,2860,2.0,8,2860,0,47.661,1440
5407,4,2.5,1940,2.0,8,1940,0,47.4507,1900
5408,2,1.0,920,1.0,6,920,0,47.6576,1570
5409,1,1.5,1900,1.5,9,1450,450,47.4718,2920
5410,2,1.0,1140,1.0,7,850,290,47.6827,1410
5411,3,1.0,1320,1.0,7,1320,0,47.2787,1260
5412,4,3.0,2170,1.0,8,1370,800,47.6291,2020
5413,3,2.5,2020,2.0,8,2020,0,47.6927,2410
5414,4,2.0,2660,1.5,7,1480,1180,47.6398,2350
5415,3,2.0,2740,1.0,9,2740,0,47.5056,2140
5416,3,1.75,1360,1.0,7,1000,360,47.5711,1540
5417,3,1.75,1800,2.0,7,1800,0,47.6842,1310
5418,3,2.75,1360,1.0,7,1140,220,47.2069,1700
5419,3,2.0,1640,1.0,7,820,820,47.5945,2270
5420,3,2.25,1780,2.0,7,1780,0,47.3718,1820
5421,4,2.5,2170,1.0,8,1820,350,47.5672,2390
5422,2,1.0,790,1.0,6,790,0,47.4928,1150
5423,2,1.0,1040,1.0,6,1040,0,47.5387,1390
5424,4,1.0,1470,1.5,7,1470,0,47.6458,2160
5425,3,2.25,2440,1.0,7,1480,960,47.7705,2510
5426,3,2.25,1820,1.0,8,1220,600,47.5898,2050
5427,3,2.25,1820,1.0,8,1220,600,47.5898,2050
5428,5,3.25,3490,1.0,8,1890,1600,47.5701,2660
5429,4,1.5,2440,1.0,8,1440,1000,47.7081,2140
5430,3,2.25,1980,1.0,9,1560,420,47.3149,2360
5431,3,2.5,2420,2.0,9,2420,0,47.6599,2630
5432,4,1.75,960,1.0,6,580,380,47.5372,1720
5433,3,1.75,2880,1.0,8,1580,1300,47.4881,1380
5434,3,1.5,1140,1.0,7,840,300,47.4752,1200
5435,4,1.75,1720,1.5,7,1460,260,47.57899999999999,1930
5436,3,2.5,1620,1.0,6,1620,0,47.2138,1620
5437,3,1.75,1570,1.0,7,970,600,47.5889,1790
5438,4,1.0,1650,1.0,7,1650,0,47.6366,2240
5439,3,1.0,1040,2.0,6,1040,0,47.5121,1030
5440,3,2.5,1656,1.0,7,1656,0,47.3758,2030
5441,4,2.0,2090,1.5,7,1790,300,47.6881,1660
5442,4,2.5,2980,1.5,8,1800,1180,47.70399999999999,2340
5443,2,1.0,1280,1.0,8,1020,260,47.6938,1540
5444,2,1.75,1980,2.0,7,1280,700,47.4193,1680
5445,4,4.0,2740,2.0,9,2740,0,47.3735,2290
5446,2,1.0,1400,1.0,7,1400,0,47.7228,1760
5447,3,1.75,2270,1.0,7,1370,900,47.4864,1210
5448,4,1.0,1510,1.5,7,1510,0,47.6526,1560
5449,2,1.0,1150,1.0,7,1050,100,47.6846,1463
5450,3,1.75,2180,1.0,8,1380,800,47.6501,2020
5451,4,2.5,2560,2.0,8,2560,0,47.3692,2130
5452,5,2.75,3550,2.0,7,3550,0,47.6766,3370
5453,4,3.25,3470,1.0,11,2270,1200,47.5513,3910
5454,3,2.0,1500,1.0,7,1500,0,47.7279,1580
5455,2,1.0,920,1.0,6,920,0,47.5281,1040
5456,3,1.0,1470,1.0,7,1040,430,47.7347,1420
5457,2,1.0,1150,1.0,7,1150,0,47.6539,2240
5458,3,2.5,1740,2.0,8,1320,420,47.525,1740
5459,2,1.75,1320,1.0,7,1080,240,47.6639,2070
5460,4,3.5,3150,2.0,9,3150,0,47.6644,1550
5461,3,1.5,1010,1.0,7,1010,0,47.379,1640
5462,2,1.0,1440,1.0,7,860,580,47.7431,1550
5463,4,2.5,2300,2.0,9,2300,0,47.6273,2280
5464,4,1.0,1330,1.0,7,970,360,47.6038,1590
5465,3,1.0,1200,1.5,7,1200,0,47.5209,1380
5466,3,1.75,1440,1.0,6,720,720,47.567,1500
5467,4,2.5,2400,2.0,8,2400,0,47.4881,2040
5468,4,2.5,1960,2.0,8,1960,0,47.3293,2360
5469,3,2.5,1270,2.0,8,1270,0,47.5357,1420
5470,3,1.5,1830,1.5,5,1830,0,47.2057,1520
5471,3,2.75,2340,1.0,8,1470,870,47.7379,2640
5472,3,1.0,1030,1.0,7,1030,0,47.4905,1030
5473,3,4.0,1390,2.0,9,1150,240,47.67100000000001,1620
5474,3,2.75,2330,2.0,8,1730,600,47.3459,1100
5475,3,0.75,1240,1.0,7,1240,0,47.7298,1210
5476,3,1.0,1410,1.0,7,1050,360,47.534,1800
5477,3,2.75,1900,1.0,7,1900,0,47.3144,1640
5478,3,2.25,1860,3.0,8,1860,0,47.7006,1760
5479,5,1.75,2840,2.0,7,2840,0,47.4961,2170
5480,2,2.0,1930,1.0,8,1930,0,47.7054,1900
5481,2,1.0,720,1.0,6,720,0,47.5352,670
5482,2,1.75,1240,1.0,7,890,350,47.6689,1640
5483,3,1.75,2120,1.0,8,1260,860,47.6475,2040
5484,4,2.5,2440,2.0,8,1700,740,47.6472,2020
5485,1,1.0,520,1.0,5,520,0,47.5533,800
5486,2,1.75,2070,1.0,7,1260,810,47.6551,1690
5487,5,2.5,2250,1.0,7,1360,890,47.7316,1820
5488,4,2.0,1880,1.0,7,970,910,47.5929,1670
5489,2,1.75,1660,1.0,8,1660,0,47.713,1670
5490,4,3.0,1680,1.0,7,1150,530,47.2885,1820
5491,3,2.5,2440,1.0,7,1520,920,47.6857,2440
5492,4,2.5,3520,2.0,10,3520,0,47.6084,3490
5493,2,1.0,890,1.0,6,890,0,47.4839,1260
5494,2,2.5,1320,1.0,8,1320,0,47.5157,1830
5495,3,1.0,960,1.0,7,960,0,47.7278,1580
5496,4,2.5,2770,2.0,9,2770,0,47.5688,2770
5497,4,1.0,1910,1.5,6,1910,0,47.5151,1380
5498,4,2.5,2340,2.0,9,2340,0,47.6283,2340
5499,3,1.0,1290,1.5,7,1290,0,47.7111,1290
5500,3,2.5,1810,3.0,8,1810,0,47.6955,1470
5501,3,2.5,1820,1.0,7,910,910,47.6892,1600
5502,4,2.5,2630,2.0,8,2630,0,47.7735,2360
5503,3,1.75,1320,1.0,7,1320,0,47.3902,1670
5504,3,2.0,1400,1.0,7,1400,0,47.3182,1270
5505,3,3.25,1280,2.0,8,1090,190,47.7032,1280
5506,3,1.75,1300,1.0,7,820,480,47.674,1180
5507,3,2.25,1780,1.0,7,1340,440,47.723,2060
5508,4,2.5,1560,1.5,7,1560,0,47.5287,1920
5509,3,2.5,2070,2.0,8,2070,0,47.7696,2740
5510,3,2.25,1580,1.0,7,1220,360,47.7599,1970
5511,3,2.75,2692,2.0,9,2692,0,47.3569,2336
5512,3,2.0,1940,1.0,7,1050,890,47.6842,1700
5513,4,2.5,2150,1.5,7,1290,860,47.5338,1920
5514,4,2.25,2880,2.0,8,2480,400,47.6999,2460
5515,6,2.5,2420,1.0,7,1420,1000,47.4459,1630
5516,3,1.0,2020,1.5,7,1520,500,47.5514,1200
5517,4,2.5,2450,2.0,7,2450,0,47.4006,3300
5518,1,1.0,690,1.0,6,690,0,47.6849,1650
5519,1,1.0,800,1.0,6,800,0,47.5581,1490
5520,3,2.25,1840,2.0,8,1840,0,47.4862,2150
5521,3,1.0,1660,1.0,7,1260,400,47.5323,1230
5522,6,3.0,2620,1.0,7,1760,860,47.678,1760
5523,3,1.75,1750,1.0,7,1750,0,47.4535,2030
5524,3,2.0,1660,1.0,7,1660,0,47.4872,2380
5525,5,3.0,2370,1.5,8,1340,1030,47.6645,1350
5526,3,2.0,1170,1.5,7,1170,0,47.5543,1400
5527,4,1.0,2020,1.0,7,2020,0,47.739,1530
5528,3,2.5,2530,2.0,8,2530,0,47.7597,2280
5529,2,1.0,870,1.0,7,870,0,47.5676,1310
5530,3,2.5,1940,2.0,8,1940,0,47.7511,2110
5531,3,3.25,4220,1.0,11,2460,1760,47.6083,3810
5532,3,3.25,2200,2.0,7,1910,290,47.6551,1410
5533,5,3.25,5570,2.0,9,3860,1710,47.6708,3170
5534,3,2.5,1720,2.0,7,1720,0,47.4039,1720
5535,3,1.75,1970,1.0,7,1270,700,47.4731,1890
5536,3,2.25,1370,2.0,7,1370,0,47.3504,1370
5537,3,2.25,2040,2.0,7,2040,0,47.2328,2020
5538,4,1.5,1920,1.0,7,1920,0,47.2858,1400
5539,3,1.5,1340,1.0,8,1340,0,47.5389,1990
5540,4,2.25,3140,2.0,9,3140,0,47.6361,2370
5541,3,1.0,1460,1.0,7,1260,200,47.6875,1430
5542,3,2.25,1810,2.0,8,1810,0,47.2994,1820
5543,3,2.5,1690,2.0,7,1690,0,47.6779,1950
5544,3,2.5,2170,1.0,7,1410,760,47.4342,1860
5545,3,3.0,2480,2.0,10,1730,750,47.6466,2950
5546,3,2.75,1990,1.0,8,1990,0,47.5544,3120
5547,5,3.75,4960,2.0,11,3760,1200,47.5491,5200
5548,3,2.25,1830,1.0,7,1250,580,47.2899,2240
5549,4,2.5,2620,1.0,7,1570,1050,47.6623,3050
5550,3,2.5,2370,2.0,9,2370,0,47.3067,2530
5551,3,1.0,940,1.0,6,940,0,47.7657,940
5552,4,2.5,2250,2.0,8,2250,0,47.449,2040
5553,4,3.5,4083,2.0,10,4083,0,47.3114,2430
5554,5,1.0,1170,1.0,6,800,370,47.7332,1590
5555,4,2.25,2380,1.0,7,2380,0,47.4253,1030
5556,4,2.5,1750,1.0,8,1410,340,47.6403,2120
5557,2,1.75,1140,2.0,8,940,200,47.6647,1160
5558,3,2.5,2960,2.0,10,2960,0,47.5906,3320
5559,4,2.5,1600,1.0,7,830,770,47.5469,1600
5560,4,2.75,2080,1.5,8,2080,0,47.6737,1730
5561,4,2.5,2880,1.0,8,2140,740,47.2887,2810
5562,3,1.5,1080,1.0,7,1080,0,47.3155,1190
5563,3,2.0,1490,1.0,7,1490,0,47.3687,1560
5564,4,4.75,4575,2.5,10,3905,670,47.6263,3900
5565,3,1.0,1200,2.0,7,1200,0,47.5883,3290
5566,3,1.75,1550,1.5,7,1550,0,47.6743,1510
5567,4,1.75,2130,1.0,7,1330,800,47.3932,1600
5568,2,1.0,900,1.0,7,900,0,47.6877,1270
5569,5,2.75,2830,1.5,7,2830,0,47.731,1700
5570,3,2.0,1640,1.0,7,1640,0,47.3589,1640
5571,3,2.5,1870,2.0,8,1870,0,47.4521,1900
5572,4,1.0,1490,1.5,7,1490,0,47.5518,1700
5573,3,1.5,2230,2.0,8,2230,0,47.5833,2200
5574,3,2.5,1620,2.0,7,1620,0,47.3613,1370
5575,5,2.5,1980,1.0,7,1080,900,47.699,1310
5576,2,1.0,1070,1.0,6,1070,0,47.5434,1330
5577,2,2.25,1800,2.0,9,1800,0,47.6104,1800
5578,3,1.75,1670,1.0,7,1340,330,47.3257,1580
5579,4,1.75,3080,1.0,9,1700,1380,47.6353,2960
5580,3,1.0,940,1.0,7,940,0,47.688,2019
5581,4,3.0,2570,1.0,8,1370,1200,47.6956,2090
5582,3,2.5,1600,2.0,7,1600,0,47.3303,1700
5583,3,2.25,1830,1.0,7,1330,500,47.7574,1830
5584,3,3.0,3110,1.0,10,1590,1520,47.6624,3150
5585,3,3.5,3600,2.0,8,3600,0,47.6982,2050
5586,3,1.75,2092,1.0,7,2092,0,47.2664,2092
5587,2,1.0,1090,1.0,7,840,250,47.6385,1070
5588,3,2.5,2010,2.0,8,2010,0,47.6904,1920
5589,3,2.25,1440,2.0,7,1440,0,47.7471,1700
5590,4,1.75,1580,2.0,7,1580,0,47.4694,1390
5591,3,1.0,970,1.0,6,970,0,47.5476,1160
5592,3,1.0,1100,1.0,7,1100,0,47.7219,1430
5593,4,2.25,3240,2.0,9,2730,510,47.5373,2610
5594,2,1.0,1450,1.0,7,1450,0,47.63,2390
5595,3,2.75,2260,2.0,8,1540,720,47.6435,2120
5596,4,2.0,1610,2.0,7,1610,0,47.6775,1300
5597,5,1.75,1880,1.0,7,1880,0,47.6059,2180
5598,3,1.0,1070,1.0,6,970,100,47.5187,1120
5599,3,2.0,1560,1.0,8,790,770,47.7261,1410
5600,2,1.0,870,1.0,6,870,0,47.7188,1500
5601,4,2.25,2520,1.5,7,1510,1010,47.5814,1460
5602,5,3.0,2150,1.0,7,1370,780,47.538,1990
5603,4,2.75,1590,1.5,8,1590,0,47.6401,1590
5604,3,2.0,1800,1.0,7,1080,720,47.6738,1800
5605,3,1.5,1390,1.0,7,1090,300,47.6611,1910
5606,3,1.75,1720,1.0,7,1140,580,47.3173,1120
5607,2,2.5,1230,2.0,7,1060,170,47.6007,1290
5608,5,1.75,2240,1.0,7,1120,1120,47.6727,1980
5609,2,1.75,1400,2.0,8,1110,290,47.5478,1380
5610,4,2.0,2060,1.0,8,1370,690,47.5237,2060
5611,3,1.0,1540,1.0,7,1540,0,47.522,1220
5612,3,2.5,2550,2.0,7,2550,0,47.3828,2080
5613,4,2.5,3670,2.0,10,3670,0,47.6219,3040
5614,4,3.25,4420,2.0,11,3150,1270,47.572,2760
5615,3,1.5,1550,1.0,7,1550,0,47.2012,1450
5616,2,1.0,1020,1.0,6,1020,0,47.4971,1200
5617,2,1.0,910,1.0,6,910,0,47.7399,1240
5618,3,1.5,1320,1.0,7,1320,0,47.7405,1250
5619,2,2.5,1240,2.0,7,1240,0,47.3236,1430
5620,4,2.5,2960,2.0,9,2960,0,47.5677,2480
5621,2,1.0,1100,1.0,7,1100,0,47.6361,1110
5622,3,1.0,1200,1.0,6,1200,0,47.7763,1340
5623,2,2.0,1390,2.0,7,1390,0,47.3089,1390
5624,2,0.75,840,1.0,6,840,0,47.4727,1240
5625,4,2.25,2060,2.0,8,2060,0,47.7228,1610
5626,4,2.25,2000,1.0,7,1350,650,47.4238,1650
5627,1,1.0,700,1.0,7,700,0,47.5662,1340
5628,3,3.0,1380,3.0,8,1380,0,47.6692,1390
5629,3,2.25,1520,2.0,8,1400,120,47.5787,1420
5630,3,1.5,1470,1.0,7,1130,340,47.6693,2120
5631,4,2.25,2500,2.0,9,2500,0,47.6604,2630
5632,3,1.5,1340,1.0,7,1340,0,47.5866,1590
5633,2,0.75,550,1.0,5,550,0,47.511,1330
5634,4,3.5,3160,2.0,8,2180,980,47.5963,2180
5635,4,1.0,1170,1.5,7,1170,0,47.6804,1430
5636,4,2.75,2220,1.0,7,1170,1050,47.5801,1540
5637,4,2.25,2250,2.0,8,2250,0,47.3715,2140
5638,3,3.25,1510,2.0,8,1230,280,47.6683,1540
5639,3,1.0,1350,1.0,6,1350,0,47.6606,1520
5640,3,2.5,2950,2.0,8,2950,0,47.4828,2400
5641,5,1.0,1260,1.5,7,1260,0,47.5058,910
5642,4,3.0,3320,2.0,9,2120,1200,47.6474,2400
5643,4,2.75,2500,1.0,8,2120,380,47.3364,2370
5644,4,2.0,2260,2.0,9,2260,0,47.6251,2410
5645,4,3.5,3680,2.5,9,2670,1010,47.6192,1350
5646,3,2.0,2510,1.0,8,1470,1040,47.5631,990
5647,3,2.0,1570,1.0,8,1570,0,47.4286,2010
5648,3,1.75,1950,1.0,7,1950,0,47.4391,1820
5649,4,2.0,1200,1.0,7,1200,0,47.3262,1110
5650,3,2.5,1540,3.0,8,1470,70,47.6961,1540
5651,5,4.0,4280,2.0,10,2710,1570,47.5503,3080
5652,2,2.0,1350,1.0,8,1350,0,47.6338,1800
5653,4,2.25,2760,2.0,9,2760,0,47.6285,2850
5654,4,3.5,3470,2.0,8,2520,950,47.7146,2360
5655,3,2.0,1730,1.0,8,1730,0,47.3573,2000
5656,2,1.0,1030,1.0,6,1030,0,47.6962,1220
5657,3,2.25,1410,1.0,7,940,470,47.5396,1550
5658,2,1.0,810,1.0,6,810,0,47.5337,1400
5659,3,1.75,1370,2.0,7,1370,0,47.258,1530
5660,5,2.5,2510,1.0,8,1410,1100,47.4732,2170
5661,3,3.25,1510,3.0,8,1510,0,47.6711,1390
5662,4,1.75,1320,1.0,7,1320,0,47.4297,1620
5663,3,1.5,1180,1.0,7,1180,0,47.3838,1150
5664,3,2.5,2470,2.0,9,2470,0,47.6694,2450
5665,5,4.0,7320,2.0,11,7320,0,47.4473,3270
5666,1,1.0,720,1.0,6,720,0,47.3509,1120
5667,3,1.75,1240,1.0,6,1240,0,47.37,1240
5668,4,1.75,2800,1.0,9,1400,1400,47.6803,1490
5669,4,2.0,1400,2.0,7,1400,0,47.6168,1620
5670,4,3.0,2860,1.0,8,2860,0,47.6286,1840
5671,4,3.5,4270,2.0,10,4270,0,47.5489,4190
5672,4,2.5,2010,2.0,8,2010,0,47.3406,1910
5673,4,1.0,1430,1.0,6,1070,360,47.7623,1460
5674,4,2.25,2580,2.0,8,2580,0,47.5647,2390
5675,3,2.75,1690,1.0,7,1180,510,47.7336,1560
5676,3,1.75,3440,1.5,8,3440,0,47.449,2160
5677,4,2.5,3270,2.0,10,3270,0,47.6018,3460
5678,4,2.75,2700,2.0,9,2700,0,47.3496,2700
5679,4,1.75,1940,1.0,7,970,970,47.7108,1460
5680,4,1.0,1620,1.5,7,1620,0,47.5728,1220
5681,5,1.75,2000,1.0,7,1200,800,47.5084,2340
5682,6,3.0,2480,2.0,8,2480,0,47.6127,2480
5683,3,2.25,1860,1.5,7,1020,840,47.5539,1180
5684,4,1.0,1660,1.5,7,1180,480,47.5391,1120
5685,3,2.5,1850,1.0,7,1500,350,47.3063,2140
5686,4,2.75,1970,1.0,8,1970,0,47.4375,1970
5687,3,3.0,1520,2.0,7,1520,0,47.572,1320
5688,3,1.5,1400,1.5,7,1400,0,47.4471,1350
5689,3,1.5,1030,1.0,7,1030,0,47.4282,1460
5690,3,1.75,2390,1.0,7,1560,830,47.4789,1750
5691,4,1.5,1600,1.5,6,1600,0,47.5681,1410
5692,4,1.5,1600,1.5,6,1600,0,47.5681,1410
5693,3,2.0,1470,1.5,7,1470,0,47.3084,1390
5694,3,2.5,1680,2.0,8,1680,0,47.4482,2080
5695,3,2.75,2380,2.0,9,1930,450,47.6626,3370
5696,3,2.5,2670,2.0,9,2000,670,47.5855,2320
5697,4,3.0,3140,1.0,9,2140,1000,47.5462,2760
5698,4,2.5,3120,2.0,9,2590,530,47.3535,2030
5699,3,1.0,1010,1.0,6,1010,0,47.2699,1370
5700,2,0.75,900,1.0,6,900,0,47.5083,1220
5701,3,2.5,1990,2.0,7,1990,0,47.36,1980
5702,4,3.75,4040,2.0,11,4040,0,47.5189,3940
5703,4,1.5,1820,1.5,7,1820,0,47.7321,1770
5704,2,2.25,1140,2.0,8,1010,130,47.659,1140
5705,5,2.0,1730,1.0,5,1730,0,47.5076,1940
5706,2,1.0,970,1.0,7,970,0,47.556,1180
5707,2,2.0,1360,1.0,7,780,580,47.6874,1340
5708,3,1.5,1370,1.5,6,1370,0,47.4731,1370
5709,3,1.75,2610,2.0,8,2130,480,47.6287,3010
5710,3,3.0,2630,2.0,9,2630,0,47.693000000000005,2880
5711,3,1.75,1810,1.0,7,1810,0,47.6236,1680
5712,3,2.0,2060,1.0,7,1060,1000,47.574,1400
5713,3,2.0,1350,1.0,7,1350,0,47.7315,2100
5714,4,2.5,3060,2.0,9,3060,0,47.3689,3040
5715,4,2.75,2530,2.0,8,2530,0,47.737,2530
5716,4,2.5,1790,1.0,7,1790,0,47.3617,1760
5717,5,2.25,2400,1.0,7,1200,1200,47.6007,1950
5718,4,2.5,2410,1.0,8,1550,860,47.7153,2330
5719,4,2.25,2190,2.0,8,1800,390,47.6425,2100
5720,3,1.75,1880,1.0,7,880,1000,47.7004,1260
5721,3,3.0,2410,2.0,9,2410,0,47.747,2540
5722,5,2.75,2620,1.0,8,1350,1270,47.5226,1940
5723,3,2.25,1850,2.0,9,1850,0,47.5525,1080
5724,3,2.25,1760,1.0,7,1190,570,47.6525,2260
5725,4,1.75,2400,1.0,8,1590,810,47.4282,2200
5726,3,1.0,1850,1.5,7,1850,0,47.6727,1850
5727,3,2.5,3490,2.0,9,2150,1340,47.7265,2990
5728,4,2.5,3230,2.0,9,3230,0,47.6318,3230
5729,3,1.75,1940,1.0,8,1440,500,47.5239,2160
5730,4,2.5,1810,2.0,8,1810,0,47.4088,1850
5731,3,1.0,1270,1.5,7,1270,0,47.5433,2100
5732,3,2.5,1980,2.0,10,1580,400,47.4551,2060
5733,2,2.25,2910,2.0,9,2910,0,47.5279,2090
5734,2,1.0,800,1.0,6,800,0,47.6913,1470
5735,2,1.0,930,1.0,6,730,200,47.5321,1100
5736,1,1.0,1180,1.0,6,1180,0,47.4007,1890
5737,4,2.0,1890,1.5,7,1670,220,47.6633,1800
5738,3,1.0,1310,1.0,7,1310,0,47.2574,1600
5739,5,2.5,1760,1.5,6,1760,0,47.5271,1370
5740,3,1.75,1730,1.0,8,1730,0,47.7149,1440
5741,3,1.0,1010,1.0,7,1010,0,47.7351,1310
5742,3,2.5,2400,2.0,8,2400,0,47.7361,2230
5743,3,1.5,1540,1.0,7,1540,0,47.5237,1690
5744,4,2.5,2520,2.0,9,2520,0,47.5524,2910
5745,5,2.5,2670,1.0,8,1410,1260,47.3429,1860
5746,3,2.0,1440,1.0,8,1440,0,47.7022,1350
5747,3,1.0,1050,1.5,7,1050,0,47.5169,1050
5748,4,2.5,2390,2.0,8,2390,0,47.7066,2610
5749,3,1.75,2370,1.0,7,1280,1090,47.5039,1990
5750,4,2.5,2760,1.5,7,1680,1080,47.6726,1850
5751,3,1.75,1540,1.0,8,1540,0,47.5172,1330
5752,3,1.75,1760,1.0,7,1160,600,47.5773,1840
5753,3,1.0,1580,1.0,7,1000,580,47.3318,1580
5754,2,1.0,860,1.0,5,860,0,47.492,960
5755,3,1.0,1010,1.5,6,1010,0,47.5657,1330
5756,3,1.0,1320,1.0,7,1320,0,47.4902,1370
5757,5,2.0,2940,2.0,9,2340,600,47.6466,2940
5758,4,1.0,1460,1.5,7,1460,0,47.7602,1690
5759,3,2.0,2620,1.0,7,2620,0,47.4096,1730
5760,2,2.0,1140,1.0,6,1140,0,47.5277,1880
5761,3,2.5,2750,2.0,9,2750,0,47.4745,2710
5762,6,3.75,2770,1.0,8,1870,900,47.669,1570
5763,4,2.0,1710,1.0,7,1030,680,47.395,1710
5764,2,2.5,2300,1.0,8,2300,0,47.7087,1820
5765,3,2.5,2180,2.0,8,2180,0,47.5714,2150
5766,5,2.25,2510,2.0,8,2510,0,47.5339,2510
5767,3,2.5,2270,2.0,8,2270,0,47.5326,2550
5768,4,3.25,3820,2.0,10,3820,0,47.6097,2790
5769,4,3.5,3360,2.0,9,2450,910,47.3047,2580
5770,3,1.0,1000,1.0,7,860,140,47.6857,1000
5771,3,1.75,1670,1.0,7,990,680,47.5209,1230
5772,4,1.5,2040,1.0,7,1020,1020,47.5965,1490
5773,3,1.0,1010,1.0,7,1010,0,47.3437,2020
5774,5,3.0,2560,1.0,8,1590,970,47.7657,2500
5775,3,2.0,2030,1.0,7,2030,0,47.5082,1760
5776,2,1.5,1090,1.0,7,950,140,47.6836,1640
5777,4,3.5,3400,2.0,8,2500,900,47.4335,1300
5778,2,1.0,1150,1.0,6,780,370,47.5624,1150
5779,2,1.75,1930,1.0,8,1430,500,47.7576,2840
5780,3,1.0,1150,1.0,7,1150,0,47.5624,1880
5781,2,2.0,2010,1.5,7,1450,560,47.5596,1660
5782,3,1.75,2050,1.0,8,2050,0,47.5743,3180
5783,2,1.0,650,1.0,6,650,0,47.6185,1310
5784,2,1.5,1300,2.0,8,1160,140,47.6727,1430
5785,3,2.5,2730,2.0,10,2730,0,47.58,2800
5786,3,2.75,3280,1.0,9,2040,1240,47.5606,3150
5787,3,1.0,1770,1.0,7,1770,0,47.7715,2000
5788,4,2.0,1220,1.0,7,1220,0,47.5011,1220
5789,4,1.75,2100,1.0,7,1300,800,47.7049,1840
5790,2,1.0,1170,1.0,6,1170,0,47.6729,1170
5791,3,1.0,1240,1.0,7,1240,0,47.6199,1240
5792,3,2.5,2650,1.0,8,2650,0,47.4212,1940
5793,2,2.5,3360,2.0,9,3360,0,47.7112,2510
5794,4,2.5,2890,2.0,8,2890,0,47.7385,2840
5795,3,1.0,1010,1.0,6,1010,0,47.4914,1250
5796,3,1.75,1880,1.0,7,1880,0,47.3213,2230
5797,2,1.0,800,1.0,6,800,0,47.7037,1910
5798,5,2.25,1980,1.0,7,1260,720,47.3984,1880
5799,2,1.75,2040,1.5,7,2040,0,47.3979,2040
5800,4,2.5,1960,1.0,8,1290,670,47.4947,2490
5801,4,4.25,3250,2.0,8,2360,890,47.6322,1800
5802,3,2.5,2080,1.0,7,2080,0,47.4032,2080
5803,4,2.75,3140,1.0,8,1570,1570,47.5675,2430
5804,3,1.75,1810,1.0,7,1290,520,47.4484,1550
5805,4,1.0,1120,1.0,6,1120,0,47.508,1120
5806,4,1.75,1790,1.5,6,1410,380,47.4963,1790
5807,3,2.5,1810,2.0,7,1810,0,47.3715,1880
5808,3,2.0,1660,1.0,7,1000,660,47.6789,1700
5809,3,2.5,2880,2.0,9,2880,0,47.5633,2840
5810,4,1.75,2630,1.0,8,1430,1200,47.7158,2240
5811,1,1.75,1020,1.0,7,770,250,47.6724,1230
5812,4,2.25,2200,2.0,8,2200,0,47.7682,2400
5813,4,2.25,1970,1.0,8,1390,580,47.7219,1970
5814,4,2.75,2180,1.0,7,1330,850,47.4045,1500
5815,3,2.0,1440,1.0,8,1440,0,47.5753,1980
5816,4,2.0,1530,1.0,7,1530,0,47.7309,1480
5817,5,3.0,2700,2.0,10,2700,0,47.6811,1610
5818,4,2.5,2230,2.0,8,1630,600,47.6304,2410
5819,2,1.75,1390,1.0,8,1390,0,47.3785,1390
5820,3,2.25,2760,2.0,10,2760,0,47.6501,3030
5821,3,2.5,1960,2.0,8,1960,0,47.7573,2020
5822,3,3.25,2640,2.0,9,1840,800,47.6636,1990
5823,4,2.75,2890,1.0,8,1560,1330,47.734,1900
5824,6,2.5,2000,1.5,7,1790,210,47.3841,1710
5825,3,2.5,2320,2.0,8,1620,700,47.6278,2160
5826,5,2.5,2380,1.0,8,1540,840,47.7,2270
5827,4,1.75,1620,1.5,7,1620,0,47.5746,1450
5828,3,2.5,2320,2.0,8,2320,0,47.539,2500
5829,4,2.75,1830,1.0,7,1250,580,47.2989,1730
5830,3,1.5,1520,1.0,7,1160,360,47.3855,1460
5831,4,3.75,5300,2.0,11,5300,0,47.7283,3730
5832,3,1.0,1370,1.0,7,1370,0,47.2769,1770
5833,4,2.75,3210,1.0,7,1810,1400,47.7338,1840
5834,3,1.0,1200,1.0,7,1200,0,47.3864,1200
5835,2,1.0,710,1.0,6,710,0,47.479,1070
5836,3,1.75,1360,1.0,7,1360,0,47.3657,1610
5837,3,1.0,1640,2.0,6,1640,0,47.7656,1620
5838,3,2.0,1830,1.0,8,1830,0,47.5531,1770
5839,4,3.0,4260,2.0,11,4260,0,47.5874,3490
5840,3,1.0,1260,1.0,7,1260,0,47.4444,1530
5841,4,1.0,2300,1.0,7,1270,1030,47.524,1840
5842,2,1.0,890,1.0,6,890,0,47.5526,1160
5843,3,3.5,1650,2.0,7,1100,550,47.6302,1580
5844,4,1.75,2320,1.5,7,2170,150,47.6893,1390
5845,4,3.5,3260,2.0,9,2630,630,47.6598,2600
5846,3,1.5,1730,1.0,7,1250,480,47.5645,1370
5847,4,2.5,3320,2.5,10,3320,0,47.6263,3680
5848,1,1.0,1660,1.0,7,830,830,47.6821,1100
5849,3,2.0,2020,1.0,7,1220,800,47.7278,1600
5850,4,1.75,1940,1.0,7,1000,940,47.6786,1320
5851,2,2.0,860,1.0,6,860,0,47.5633,1290
5852,3,2.25,1780,2.0,8,1540,240,47.6004,2220
5853,4,2.5,2100,3.0,8,1580,520,47.5928,1490
5854,3,1.0,1100,1.5,6,1100,0,47.5279,960
5855,3,2.25,1381,3.0,8,1381,0,47.711000000000006,1381
5856,3,1.0,960,1.0,7,960,0,47.7758,1540
5857,8,3.0,3840,1.0,7,2530,1310,47.7111,1380
5858,3,1.0,1500,1.0,7,1000,500,47.6718,1640
5859,3,1.0,1500,1.0,7,1500,0,47.4666,1350
5860,4,1.75,2710,1.0,8,1440,1270,47.5523,1960
5861,3,2.0,1580,1.0,6,790,790,47.4927,1090
5862,4,2.5,1810,1.0,8,1470,340,47.2202,1850
5863,3,1.75,1910,1.0,7,1100,810,47.5995,1910
5864,2,2.0,1200,1.0,7,600,600,47.627,1790
5865,3,3.5,3080,2.0,11,2530,550,47.6321,4120
5866,3,3.0,3850,2.0,10,3850,0,47.5535,2970
5867,4,2.5,1750,2.0,7,1750,0,47.3149,1890
5868,3,2.0,1860,1.0,9,1860,0,47.4298,2500
5869,4,2.5,2870,1.0,8,1870,1000,47.5678,2670
5870,3,1.75,2200,1.0,7,2200,0,47.7659,1690
5871,3,1.5,960,1.0,7,960,0,47.3018,1160
5872,4,1.75,1420,1.5,7,1420,0,47.6771,1490
5873,4,3.5,4065,2.0,10,4065,0,47.6209,3070
5874,4,2.75,2490,1.0,8,1400,1090,47.7496,2060
5875,4,2.0,1630,1.5,6,1030,600,47.6472,1780
5876,4,1.0,2100,1.0,7,1050,1050,47.476000000000006,1540
5877,3,2.5,1830,2.0,8,1830,0,47.6022,1830
5878,3,1.75,2210,1.0,8,1390,820,47.5924,2050
5879,4,1.5,1570,1.0,6,1570,0,47.307,1140
5880,3,1.75,1310,1.0,7,1310,0,47.2761,1580
5881,2,1.0,1840,1.0,7,1160,680,47.5764,1750
5882,3,3.5,2070,1.0,8,1370,700,47.537,1930
5883,3,1.5,1200,1.0,6,1200,0,47.5122,1440
5884,4,2.25,2350,2.0,8,2350,0,47.7628,2210
5885,3,1.0,1120,1.0,7,1120,0,47.3732,1190
5886,1,1.0,1020,1.0,6,1020,0,47.5051,1260
5887,2,2.5,2680,1.0,9,2680,0,47.7094,2310
5888,3,1.5,1010,1.5,7,1010,0,47.72,1550
5889,3,1.75,1590,1.0,7,1590,0,47.4815,2980
5890,3,1.0,960,1.0,6,960,0,47.2819,960
5891,5,3.25,2860,1.0,7,1800,1060,47.7757,1920
5892,4,2.0,2750,1.0,8,2750,0,47.457,1340
5893,2,1.0,710,1.0,5,710,0,47.64,1810
5894,3,2.75,3290,2.0,8,3290,0,47.5241,2750
5895,4,2.0,1990,1.0,9,1260,730,47.6515,1770
5896,4,3.25,5080,2.0,11,5080,0,47.5423,4730
5897,3,1.5,1740,2.0,9,1740,0,47.6276,2580
5898,0,0.0,290,1.0,1,290,0,47.5308,1620
5899,3,2.25,2120,2.0,7,2120,0,47.3596,2120
5900,3,2.0,2010,2.0,8,1510,500,47.7416,1780
5901,4,2.0,1910,1.5,8,1910,0,47.6893,1360
5902,3,1.0,1580,1.0,7,1010,570,47.4607,1710
5903,5,1.75,2650,1.0,8,2650,0,47.626000000000005,2780
5904,3,1.0,1020,1.0,6,1020,0,47.4459,1690
5905,4,1.75,2120,1.0,8,1640,480,47.7753,2310
5906,4,1.0,1430,1.0,6,730,700,47.7417,1310
5907,5,3.0,2730,1.0,8,1470,1260,47.4994,2590
5908,3,2.25,2540,1.0,8,1320,1220,47.41,1870
5909,2,1.75,1460,1.0,7,850,610,47.6928,2050
5910,3,2.5,1980,2.0,8,1980,0,47.396,2090
5911,3,1.0,1150,1.0,6,1150,0,47.7422,1400
5912,5,2.5,2730,1.0,7,1660,1070,47.7646,2250
5913,4,2.5,2560,2.0,8,2560,0,47.5222,2190
5914,3,2.0,1820,1.0,7,910,910,47.6823,1850
5915,2,1.0,940,1.0,7,940,0,47.4631,1890
5916,5,2.5,2530,2.0,7,2530,0,47.3531,2070
5917,3,2.25,1820,1.0,7,1480,340,47.7401,1930
5918,2,1.0,1510,1.0,7,880,630,47.6135,1330
5919,3,1.0,1600,1.0,7,1600,0,47.4431,1600
5920,5,2.0,2740,1.0,7,1370,1370,47.6819,1660
5921,4,3.5,4660,2.0,11,4660,0,47.5422,5080
5922,3,1.75,1590,2.0,7,1590,0,47.3819,1490
5923,2,1.0,1180,1.0,7,1180,0,47.5893,1420
5924,4,2.75,1860,1.0,8,1220,640,47.5398,2020
5925,3,1.75,1470,1.0,7,1070,400,47.6067,1280
5926,1,1.0,660,1.0,6,660,0,47.5659,1520
5927,2,1.0,770,1.0,6,770,0,47.5512,940
5928,2,1.5,1370,1.0,7,1370,0,47.7592,1370
5929,3,2.25,1850,2.0,7,1850,0,47.2843,1710
5930,4,1.75,1920,1.0,7,1470,450,47.5683,1820
5931,4,1.75,1920,1.0,7,1470,450,47.5683,1820
5932,3,3.0,4910,2.0,10,4000,910,47.5911,3540
5933,4,2.5,2210,1.0,8,1410,800,47.4915,2210
5934,3,1.0,900,1.5,7,900,0,47.684,1280
5935,4,1.75,1960,1.0,8,980,980,47.6847,1630
5936,4,3.0,5430,2.0,10,5430,0,47.6582,3170
5937,4,1.75,2190,1.0,9,2190,0,47.2703,3000
5938,4,1.5,1200,1.0,7,1200,0,47.3423,1250
5939,3,1.75,1040,1.0,7,800,240,47.6385,1630
5940,4,2.0,2210,1.0,8,1210,1000,47.6498,2190
5941,2,1.5,1070,2.0,7,1070,0,47.697,1070
5942,2,1.0,950,1.5,7,950,0,47.6288,2040
5943,3,2.75,2950,2.0,9,2950,0,47.5577,3340
5944,4,1.0,1290,1.5,7,1290,0,47.5128,1440
5945,2,2.0,1690,1.0,8,1690,0,47.7133,1640
5946,4,2.5,3750,2.0,10,3750,0,47.3045,2540
5947,3,2.0,2250,1.5,8,2250,0,47.3165,2460
5948,3,1.5,1660,1.0,7,1210,450,47.5345,1440
5949,3,1.0,1460,1.0,7,1460,0,47.4243,1460
5950,3,2.0,1570,1.0,7,1570,0,47.7501,1410
5951,3,2.5,1480,3.0,8,1480,0,47.62,1480
5952,5,3.0,3610,2.0,8,3610,0,47.3545,2800
5953,3,2.0,2440,1.0,6,1640,800,47.4594,1630
5954,3,1.0,1150,1.0,7,1010,140,47.5974,2460
5955,2,1.0,900,1.0,7,900,0,47.6855,1460
5956,4,2.5,3210,1.5,11,3210,0,47.6399,3280
5957,4,2.5,2950,2.0,10,2950,0,47.6651,2950
5958,4,2.5,3700,2.0,9,3700,0,47.7473,3050
5959,4,2.5,2730,2.0,8,2730,0,47.3363,2150
5960,4,3.5,3180,2.0,8,2390,790,47.4482,2850
5961,3,2.25,998,2.0,7,798,200,47.6983,998
5962,4,2.5,3420,2.0,9,3420,0,47.718,2520
5963,4,3.5,2870,2.0,9,2070,800,47.5009,1770
5964,3,2.5,1600,2.0,8,1600,0,47.5341,1445
5965,2,1.5,960,2.0,7,960,0,47.6032,1470
5966,4,2.5,2575,2.0,8,2575,0,47.3058,2575
5967,3,2.25,1420,2.0,8,940,480,47.5703,1400
5968,4,3.25,3276,2.0,9,3276,0,47.4585,2010
5969,5,3.75,2890,1.0,7,1310,1580,47.5701,1930
5970,2,2.25,1300,3.0,8,1300,0,47.6536,1300
5971,2,1.75,1250,2.0,7,1040,210,47.6004,1250
5972,4,2.5,2030,2.0,8,2030,0,47.3515,2040
5973,3,2.5,1270,2.0,7,1080,190,47.5351,1630
5974,3,3.25,1720,2.0,8,1030,690,47.62,1720
5975,6,4.25,4310,2.0,8,2950,1360,47.6214,2100
5976,3,2.5,1584,2.0,7,1584,0,47.3451,1584
5977,4,3.5,2970,2.0,8,2260,710,47.4776,2970
5978,5,3.25,3340,2.0,8,2600,740,47.5446,2770
5979,4,2.75,3430,2.0,9,3050,380,47.7079,3070
5980,5,3.5,3220,2.0,8,3220,0,47.7048,2970
5981,3,3.5,1500,2.0,8,1240,260,47.6727,1440
5982,4,2.75,2790,2.0,8,2790,0,47.4831,2620
5983,3,2.5,4090,2.0,11,3590,500,47.7258,3740
5984,3,2.25,1570,3.0,8,1570,0,47.6585,1290
5985,4,3.75,4120,2.0,10,4120,0,47.5872,3730
5986,3,2.5,2390,2.0,8,2220,170,47.5405,2150
5987,4,3.5,3510,2.0,10,3510,0,47.5413,3690
5988,4,2.0,2340,1.0,7,2340,0,47.4842,1180
5989,3,1.5,1260,2.0,7,1040,220,47.7111,1260
5990,3,2.75,2670,2.0,8,2670,0,47.3483,2340
5991,5,4.25,4660,2.0,11,4660,0,47.6326,3340
5992,3,2.5,1570,3.0,8,1570,0,47.6961,1570
5993,3,2.25,1420,3.0,8,1420,0,47.6533,1530
5994,3,2.5,2010,2.0,7,2010,0,47.3338,2280
5995,3,2.5,2370,2.0,8,2370,0,47.3696,2370
5996,4,2.5,2560,2.0,8,2560,0,47.4899,2560
5997,3,2.5,1900,2.0,7,1900,0,47.5941,2260
5998,3,2.5,1800,2.0,8,1800,0,47.5455,1580
5999,2,2.5,1590,2.0,8,1590,0,47.5449,1590
6000,4,2.5,2430,2.0,7,2430,0,47.515,2430
6001,3,3.25,1370,2.0,8,1100,270,47.5639,1370
6002,4,3.5,5050,2.0,11,3610,1440,47.6364,2430
6003,4,2.5,2610,2.0,9,2610,0,47.5137,2720
6004,4,2.75,3730,2.0,10,3730,0,47.6036,3670
6005,4,2.5,3330,2.0,9,3330,0,47.679,2640
6006,3,2.25,1590,3.0,8,1590,0,47.5402,1640
6007,4,2.5,3250,2.0,8,3250,0,47.4944,3030
6008,5,4.5,4590,2.0,10,4590,0,47.664,3030
6009,4,2.75,3070,2.0,9,3070,0,47.4897,2880
6010,4,3.5,3150,2.0,7,3150,0,47.3993,2950
6011,4,2.5,3100,2.0,9,3100,0,47.3785,2450
6012,4,4.0,7850,2.0,12,7850,0,47.5406,6210
6013,4,2.75,3590,2.0,10,3590,0,47.6959,3590
6014,4,2.0,1590,3.0,7,1590,0,47.54,1390
6015,3,2.5,2242,2.0,8,2242,0,47.2581,2009
6016,3,2.0,1530,3.0,9,1530,0,47.6692,1620
6017,4,2.75,3550,2.0,9,3550,0,47.7076,3140
6018,1,1.5,1120,3.0,7,1120,0,47.5924,1380
6019,4,3.5,4490,2.0,9,3390,1100,47.5394,4290
6020,3,2.5,2130,2.0,8,1840,290,47.7329,2130
6021,4,2.5,1847,2.0,7,1847,0,47.2872,1847
6022,4,2.5,2240,2.0,8,2240,0,47.496,700
6023,5,3.5,4000,2.0,9,4000,0,47.5265,3690
6024,3,2.5,1480,3.0,8,1480,0,47.669,1530
6025,2,3.0,2210,2.0,10,1500,710,47.6166,1720
6026,3,2.5,1720,2.0,7,1240,480,47.5481,1610
6027,3,3.25,1480,2.0,8,1180,300,47.5555,1330
6028,3,2.5,1150,2.0,8,1020,130,47.6684,1450
6029,3,2.5,2655,2.0,8,2655,0,47.2972,2879
6030,3,2.25,1950,1.0,8,1950,0,47.431,2310
6031,2,2.5,1233,2.0,7,963,270,47.5533,1230
6032,3,2.0,1560,3.0,8,1560,0,47.605,1560
6033,5,2.75,2710,2.0,8,2710,0,47.3555,2530
6034,3,2.5,1440,2.0,8,1160,280,47.5393,1580
6035,4,2.75,2740,2.0,10,2740,0,47.4954,1220
6036,4,2.5,2910,2.0,9,2910,0,47.6659,2910
6037,4,2.75,3250,2.0,8,3250,0,47.4806,2730
6038,3,2.5,2280,3.0,9,1890,390,47.6256,1390
6039,3,3.0,1290,3.0,7,1290,0,47.7282,1230
6040,4,3.5,3290,2.0,9,3290,0,47.5573,3290
6041,3,2.5,2550,2.0,9,2550,0,47.6647,2250
6042,4,2.5,2440,2.0,9,2440,0,47.6971,1350
6043,3,2.75,2015,2.0,9,2015,0,47.45,1780
6044,3,2.5,3060,2.0,10,3060,0,47.5928,3060
6045,4,2.5,2050,2.0,8,2050,0,47.5431,1800
6046,2,2.5,1240,3.0,8,1240,0,47.6718,1240
6047,4,3.25,3750,2.0,10,3750,0,47.658,4920
6048,4,3.25,3330,2.0,9,2870,460,47.6836,2550
6049,3,2.5,2830,3.0,10,2830,0,47.6318,2830
6050,3,2.5,1610,2.0,8,1610,0,47.4496,1830
6051,3,1.5,1220,2.0,7,1220,0,47.7168,1220
6052,3,2.25,1489,2.0,7,1489,0,47.3452,1584
6053,3,2.5,1600,2.0,8,1600,0,47.2611,1608
6054,3,2.5,1260,3.0,8,1260,0,47.675,1320
6055,3,2.25,1190,2.0,7,960,230,47.677,1190
6056,5,2.75,3250,2.0,8,3250,0,47.7133,1270
6057,3,2.25,1640,3.0,8,1640,0,47.6196,1640
6058,2,1.5,690,2.0,7,690,0,47.6951,690
6059,4,2.5,3202,2.0,9,3202,0,47.3412,2425
6060,3,2.25,1347,3.0,7,1347,0,47.7306,1480
6061,1,0.75,740,1.0,6,740,0,47.6741,1430
6062,2,2.25,1200,3.0,7,1200,0,47.6715,1280
6063,3,2.0,1480,2.0,8,1000,480,47.5492,1480
6064,4,3.5,3900,2.0,10,3900,0,47.6979,3820
6065,5,3.5,3920,2.0,9,2820,1100,47.6638,3170
6066,2,1.5,1190,2.0,8,1190,0,47.6161,1280
6067,4,2.5,2311,2.0,9,2311,0,47.3276,2458
6068,4,2.5,3250,2.0,8,3250,0,47.4988,3230
6069,3,2.5,2280,2.0,8,2280,0,47.7322,2430
6070,3,2.5,2217,2.0,7,2217,0,47.2776,1470
6071,4,3.0,3240,2.0,10,3240,0,47.5919,3380
6072,4,2.5,1921,2.0,7,1921,0,47.2689,1921
6073,3,2.5,1940,2.0,8,1940,0,47.5644,1880
6074,3,2.5,1940,2.0,8,1940,0,47.5644,1880
6075,3,2.5,1480,3.0,8,1480,0,47.6533,1480
6076,3,2.5,1300,2.0,8,1100,200,47.6384,1070
6077,3,2.5,2140,2.0,8,1960,180,47.5357,2280
6078,3,2.5,1570,3.0,8,1570,0,47.6858,1570
6079,4,3.5,3273,2.0,8,2671,602,47.4477,2996
6080,4,2.75,2320,2.0,8,2320,0,47.4862,2310
6081,4,2.5,2720,2.0,9,2720,0,47.7168,1590
6082,3,3.25,1430,2.0,8,1160,270,47.6743,1160
6083,2,2.5,1450,2.0,9,1110,340,47.6692,1620
6084,4,2.75,3000,2.0,8,3000,0,47.3613,2420
6085,4,4.5,4650,2.0,11,3640,1010,47.6349,1710
6086,2,1.0,710,2.0,7,710,0,47.6413,1370
6087,3,1.75,1370,3.0,8,1370,0,47.6595,1370
6088,4,2.75,3650,2.0,7,2940,710,47.7397,2400
6089,4,2.25,3550,1.0,8,1830,1720,47.5681,2770
6090,3,3.25,1720,2.0,8,1360,360,47.6127,1720
6091,3,2.5,1820,2.0,8,1570,250,47.4643,1470
6092,4,2.5,2900,2.0,8,2900,0,47.7717,2590
6093,5,2.75,2620,2.0,9,2620,0,47.77,2620
6094,2,2.5,1340,2.0,8,940,400,47.5655,1470
6095,4,3.25,3266,2.0,8,3266,0,47.2975,3087
6096,2,1.5,1076,3.0,7,1076,0,47.7167,1076
6097,4,2.25,2240,2.0,8,2240,0,47.6212,1760
6098,3,2.5,2594,2.0,8,2594,0,47.3054,2981
6099,4,3.5,3760,2.0,9,2860,900,47.6826,1340
6100,3,2.5,1280,3.0,8,1280,0,47.6621,1450
6101,2,2.0,1370,3.0,8,1370,0,47.6721,1280
6102,4,2.5,2180,2.0,8,2180,0,47.7221,1500
6103,3,2.25,1490,2.0,7,1220,270,47.5569,1490
6104,4,2.5,2700,2.0,9,2700,0,47.5071,3160
6105,3,2.5,1870,2.0,7,1870,0,47.342,2130
6106,3,2.5,2280,2.0,8,1880,400,47.5375,2280
6107,5,3.5,3400,2.0,9,2550,850,47.543,2380
6108,2,1.5,830,2.0,7,830,0,47.5604,830
6109,5,3.25,4130,2.0,10,4130,0,47.6022,3730
6110,4,2.5,2050,2.0,9,2050,0,47.3448,2340
6111,3,2.5,1600,2.0,8,1600,0,47.5344,1445
6112,5,2.5,3190,2.0,9,3190,0,47.7246,1650
6113,3,2.5,2430,2.0,8,2430,0,47.6062,2640
6114,4,3.5,2910,2.0,9,2910,0,47.5168,2910
6115,4,3.5,2910,2.0,9,2910,0,47.5168,2910
6116,3,2.25,1413,2.0,8,1413,0,47.4196,1763
6117,3,3.25,1460,3.0,8,1460,0,47.6485,1310
6118,2,1.5,1190,3.0,8,1190,0,47.5212,1190
6119,5,2.5,3200,2.0,9,3200,0,47.5446,3290
6120,4,4.0,3770,2.0,10,2940,830,47.6476,3300
6121,4,2.75,3500,2.0,9,3500,0,47.6846,3480
6122,2,2.5,2170,1.0,8,2170,0,47.7109,2310
6123,4,2.5,2890,2.0,9,2890,0,47.7349,2890
6124,5,3.0,2230,1.0,7,1330,900,47.487,2230
6125,5,2.75,2710,2.0,8,2710,0,47.4786,2590
6126,4,3.25,3600,2.0,10,3000,600,47.5294,3970
6127,4,2.5,2290,2.0,8,2290,0,47.5518,1380
6128,3,2.0,1270,3.0,8,1270,0,47.6934,1330
6129,3,2.25,1540,3.0,8,1540,0,47.6827,1510
6130,3,2.25,1490,2.0,9,1040,450,47.6226,1490
6131,4,4.5,3130,3.0,10,2450,680,47.6239,2540
6132,5,4.5,4000,2.0,9,4000,0,47.5254,3690
6133,2,2.25,1610,2.0,7,1610,0,47.5184,1950
6134,4,3.5,3590,2.0,9,3140,450,47.6763,2100
6135,4,2.25,1800,2.0,8,1800,0,47.5165,1800
6136,2,2.25,1390,2.0,8,1165,225,47.6168,1415
6137,4,4.5,4920,2.0,10,3820,1100,47.4695,4920
6138,2,1.5,980,2.0,7,820,160,47.5925,1130
6139,3,2.5,1950,2.0,7,1950,0,47.3613,2300
6140,5,4.25,4150,2.0,10,4150,0,47.5816,3230
6141,2,1.5,1110,2.0,7,950,160,47.5427,1110
6142,3,2.5,1250,2.0,8,1080,170,47.5582,1250
6143,4,2.5,3310,2.0,9,3310,0,47.6635,2600
6144,4,2.5,2020,2.0,7,2020,0,47.4937,2020
6145,4,3.5,3310,2.0,9,3310,0,47.6954,3320
6146,4,2.5,2798,2.0,9,2798,0,47.4295,2358
6147,4,2.5,2020,2.0,7,2020,0,47.3535,2210
6148,4,2.5,2400,2.0,8,2400,0,47.4959,2710
6149,4,2.5,2110,2.0,7,2110,0,47.3612,2300
6150,4,2.5,2692,2.0,9,2692,0,47.3519,2574
6151,4,2.5,1740,2.0,7,1740,0,47.3686,1950
6152,2,1.0,970,2.0,7,790,180,47.5469,1150
6153,3,2.5,1520,2.0,7,1520,0,47.4874,1820
6154,3,2.5,2099,2.0,7,2099,0,47.3521,2099
6155,2,1.5,1090,3.0,8,1090,0,47.6974,1110
6156,4,2.5,3216,2.0,9,3216,0,47.3425,2815
6157,4,2.75,3300,2.0,9,3300,0,47.6175,3520
6158,3,1.75,1530,3.0,8,1530,0,47.5929,1580
6159,4,2.5,2190,2.0,8,2190,0,47.7705,2190
6160,4,2.5,2930,2.0,9,2930,0,47.3421,2815
6161,3,2.25,1540,3.0,8,1540,0,47.6991,1540
6162,3,2.5,2242,2.0,8,2242,0,47.2583,2009
6163,3,2.5,1950,2.0,7,1950,0,47.5202,2260
6164,3,2.5,2060,2.0,9,2060,0,47.3261,2648
6165,4,2.5,3400,2.0,9,3400,0,47.708,3070
6166,2,1.0,1140,1.5,8,1010,130,47.5494,1360
6167,3,2.75,3010,2.0,9,3010,0,47.5836,2950
6168,5,3.0,2630,2.0,8,1670,960,47.5065,2240
6169,3,2.25,1430,2.0,8,1430,0,47.5648,1270
6170,3,2.5,1230,2.0,8,1080,150,47.6518,1230
6171,4,3.5,3480,2.0,9,2460,1020,47.6356,2620
6172,5,3.0,3110,2.0,8,3110,0,47.7719,2450
6173,3,2.5,1910,2.0,8,1910,0,47.5445,1630
6174,3,2.75,2830,2.0,8,2830,0,47.5606,2160
6175,5,3.5,3700,2.0,9,3700,0,47.5929,3170
6176,4,3.0,2520,2.0,7,2520,0,47.5352,2510
6177,3,2.25,1450,2.0,8,1160,290,47.5694,1370
6178,2,1.5,1100,2.0,7,900,200,47.5538,1340
6179,4,2.5,2560,2.0,9,2560,0,47.5535,2160
6180,3,2.25,1420,3.0,8,1420,0,47.6801,1350
6181,5,2.75,3078,2.0,9,3078,0,47.3587,1979
6182,3,1.5,1270,2.0,7,1270,0,47.5671,1490
6183,5,3.25,4150,2.0,10,4150,0,47.6026,3560
6184,2,2.5,1500,2.0,8,1140,360,47.6689,1550
6185,3,2.5,1870,3.0,8,1380,490,47.6512,1440
6186,3,2.25,1240,3.0,8,1240,0,47.6748,1470
6187,3,2.75,1840,2.0,10,1700,140,47.53,2590
6188,4,3.5,3350,2.0,8,2610,740,47.5602,1820
6189,5,3.0,3010,2.0,9,3010,0,47.7226,2370
6190,3,2.5,2060,2.0,8,2060,0,47.3706,2370
6191,3,2.5,1580,2.0,8,1580,0,47.545,1710
6192,2,2.0,1405,2.0,8,1140,265,47.612,1405
6193,3,1.5,1010,2.0,8,1010,0,47.5998,1010
6194,4,5.5,6530,2.0,11,6530,0,47.664,1280
6195,3,2.75,2670,1.0,10,1720,950,47.5299,2610
6196,4,2.5,3260,2.0,9,3260,0,47.5115,3260
6197,4,3.5,4640,2.0,10,4640,0,47.531000000000006,4690
6198,3,2.5,1601,3.0,7,1536,65,47.719,1420
6199,5,3.75,5350,1.0,11,3040,2310,47.648,3740
6200,2,1.75,1030,2.0,7,765,265,47.5397,1030
6201,3,3.25,1370,3.0,8,1370,0,47.6964,1370
6202,3,2.5,1210,3.0,8,1210,0,47.6543,1210
6203,4,2.5,2890,2.0,8,2890,0,47.3494,2380
6204,4,3.25,2190,2.0,9,1540,650,47.6178,1730
6205,4,3.5,3120,2.0,9,2480,640,47.6762,1880
6206,4,2.5,2480,2.0,8,2480,0,47.3826,2480
6207,3,2.5,1510,3.0,8,1510,0,47.669,1530
6208,4,2.75,3980,2.0,9,3980,0,47.4803,2100
6209,4,3.25,3270,2.0,9,3110,160,47.6966,3600
6210,4,2.5,2670,2.0,9,2670,0,47.4876,2880
6211,3,2.25,1410,2.0,7,1290,120,47.5345,1445
6212,2,2.25,1300,2.0,8,1010,290,47.5477,1430
6213,4,2.5,2229,2.0,7,2229,0,47.3693,2738
6214,3,2.25,990,2.5,8,880,110,47.6605,1030
6215,2,2.5,1280,2.0,8,1060,220,47.6905,1290
6216,3,2.5,1610,2.0,8,1610,0,47.4497,1610
6217,2,2.5,1320,2.0,8,990,330,47.6689,1550
6218,4,2.5,3135,2.0,9,3135,0,47.3263,3008
6219,4,4.5,4020,2.0,10,4020,0,47.6358,1960
6220,3,3.25,1480,2.0,8,1180,300,47.5555,1330
6221,4,2.75,3320,2.0,9,3320,0,47.5607,3400
6222,3,2.25,1530,2.0,7,1116,414,47.7035,1320
6223,3,1.75,1140,2.0,8,1140,0,47.5638,1150
6224,4,2.5,2400,2.0,8,2400,0,47.3626,1980
6225,4,2.5,2560,2.0,8,2560,0,47.3404,2586
6226,2,1.75,1290,2.0,8,1290,0,47.5171,1410
6227,2,2.5,1630,2.0,7,1280,350,47.5489,1590
6228,3,2.25,1630,2.0,7,1630,0,47.5493,1630
6229,4,2.75,2170,2.0,8,2170,0,47.495,2460
6230,2,1.5,1020,2.0,7,1020,0,47.70399999999999,1020
6231,6,6.5,6260,2.0,11,4840,1420,47.5947,2710
6232,3,2.25,1400,2.0,7,1400,0,47.3584,1610
6233,4,2.5,2550,2.0,7,2550,0,47.5202,2430
6234,3,1.5,1260,2.0,7,1260,0,47.5524,3090
6235,4,2.5,2550,2.0,7,2550,0,47.4916,2340
6236,4,3.25,3450,2.0,8,3450,0,47.4925,1420
6237,3,3.25,1550,3.0,8,1550,0,47.6767,1550
6238,4,2.5,2890,2.0,9,2890,0,47.5456,3300
6239,4,2.5,2350,2.0,8,2350,0,47.4783,2670
6240,3,2.5,1810,2.0,8,1810,0,47.7169,1560
6241,3,2.0,1620,1.0,7,590,1030,47.5448,1700
6242,2,2.0,1070,2.0,9,720,350,47.5212,1070
6243,4,2.75,3110,2.0,9,3110,0,47.705,3590
6244,4,2.5,2303,2.0,8,2303,0,47.3258,2516
6245,3,2.5,1880,2.0,7,1880,0,47.3366,2180
6246,5,2.5,2590,2.0,8,2590,0,47.7053,3010
6247,3,2.5,1350,3.0,8,1270,80,47.549,1350
6248,5,2.5,2170,2.0,8,2170,0,47.5165,1800
6249,3,2.75,1430,2.0,9,1130,300,47.6353,1930
6250,4,2.5,2630,2.0,8,2630,0,47.5342,2550
6251,3,1.75,1410,3.0,8,1410,0,47.6558,1350
6252,4,3.5,3828,2.5,9,3828,0,47.2851,2120
6253,2,1.5,1000,3.0,8,1000,0,47.6823,2300
6254,5,3.0,3490,2.0,9,3490,0,47.7744,2870
6255,3,2.5,1800,2.0,8,1800,0,47.5442,1580
6256,3,2.5,3220,2.0,9,3220,0,47.4815,3330
6257,3,2.5,1410,2.0,7,1180,230,47.5582,1270
6258,4,3.5,3640,2.0,9,3640,0,47.7049,3590
6259,2,1.0,1131,3.0,7,1131,0,47.6912,1131
6260,3,2.25,1400,2.0,8,940,460,47.5701,1420
6261,4,2.5,2680,2.0,8,2680,0,47.4759,2680
6262,4,2.5,2680,2.0,8,2680,0,47.4759,2680
6263,2,1.75,1460,2.0,8,1000,460,47.6853,1440
6264,4,3.5,4210,2.0,9,3260,950,47.5765,3920
6265,4,2.75,2330,2.0,9,2330,0,47.5525,2410
6266,4,2.5,1710,2.0,7,1710,0,47.3448,1710
6267,5,3.75,3050,2.0,9,3050,0,47.6819,2750
6268,2,2.0,1510,1.0,8,1510,0,47.709,1510
6269,3,3.25,1530,2.0,8,1280,250,47.6179,1530
6270,3,2.5,2140,2.0,8,1960,180,47.5368,2280
6271,4,1.75,2010,1.0,7,1150,860,47.5013,1720
6272,4,2.5,2233,2.0,7,2233,0,47.2599,1544
6273,2,1.25,1240,2.0,8,1240,0,47.6884,1340
6274,4,3.0,2290,2.0,8,2290,0,47.7727,2450
6275,2,1.75,1120,2.0,7,1120,0,47.5325,1150
6276,4,2.75,3110,2.0,8,3110,0,47.4865,2610
6277,3,2.5,2230,2.0,7,2230,0,47.5439,2310
6278,3,2.5,1440,2.0,7,1440,0,47.5123,1440
6279,4,2.5,2630,2.0,9,2630,0,47.5079,2630
6280,3,3.5,1900,2.0,8,1520,380,47.5675,1530
6281,3,2.5,1350,3.0,8,1270,80,47.5491,1350
6282,4,3.25,3420,2.0,9,3030,390,47.517,3010
6283,4,2.5,2110,2.0,8,2110,0,47.356,2250
6284,2,2.25,1240,2.0,7,1150,90,47.5321,1240
6285,4,3.5,3610,2.0,9,2370,1240,47.4283,3010
6286,3,3.5,1970,2.0,8,1680,290,47.5816,1940
6287,2,2.25,860,2.0,9,860,0,47.5663,1100
6288,5,3.5,3740,2.0,9,2860,880,47.6764,1520
6289,4,2.5,2580,2.0,9,2580,0,47.5416,2580
6290,2,1.5,1090,2.0,7,1090,0,47.717,1160
6291,4,2.5,1984,1.0,8,1564,420,47.36,1390
6292,5,3.5,4750,2.0,10,3350,1400,47.3574,2160
6293,4,2.5,3060,1.5,8,3060,0,47.1967,1760
6294,3,2.5,1400,3.5,8,1400,0,47.6534,1350
6295,3,2.5,1680,2.0,7,1680,0,47.7484,1230
6296,3,2.0,2260,1.0,9,2260,0,47.4593,2340
6297,3,2.0,1239,1.0,7,1239,0,47.3689,2060
6298,3,2.5,2450,2.0,8,2450,0,47.6942,2450
6299,2,2.0,1130,2.0,9,800,330,47.6023,1350
6300,4,2.75,2790,2.0,8,2790,0,47.4827,2620
6301,2,2.0,1460,2.0,8,950,510,47.6205,1580
6302,3,2.5,1420,2.0,8,1310,110,47.7731,1180
6303,3,2.5,1650,3.0,8,1650,0,47.7108,1650
6304,4,2.5,2520,2.0,8,2520,0,47.7711,2430
6305,3,2.5,1780,2.0,8,1780,0,47.3568,1970
6306,2,2.5,1160,3.0,8,1160,0,47.6543,1320
6307,3,3.0,3460,2.0,10,2850,610,47.5858,2460
6308,2,2.5,1260,3.0,8,1260,0,47.6715,1490
6309,4,3.5,3930,2.0,10,3310,620,47.6646,3390
6310,5,3.75,3570,2.0,10,3570,0,47.5639,1760
6311,4,2.5,2478,2.0,8,2478,0,47.3524,2279
6312,4,3.5,3200,2.0,9,2500,700,47.3443,2240
6313,5,3.25,5790,2.0,10,4430,1360,47.538,5790
6314,3,3.0,1730,2.0,8,1440,290,47.5344,1370
6315,3,2.5,1790,2.0,8,1790,0,47.534,1800
6316,4,3.25,2610,2.0,10,2160,450,47.5322,2610
6317,2,1.75,1290,2.0,8,1290,0,47.5171,1410
6318,5,3.5,3560,2.0,8,2810,750,47.5542,2910
6319,4,3.25,3640,2.0,10,3640,0,47.6328,2900
6320,3,2.0,1270,3.0,8,1270,0,47.6937,1370
6321,4,2.5,1912,2.0,8,1912,0,47.3511,2020
6322,1,1.0,730,1.0,7,730,0,47.5943,1020
6323,2,2.5,1990,3.0,9,1780,210,47.6264,1955
6324,3,2.5,1300,2.0,8,880,420,47.5893,1300
6325,4,2.5,2560,2.0,8,2560,0,47.4467,1260
6326,4,3.5,3310,2.0,9,2290,1020,47.57899999999999,1850
6327,3,3.0,1950,3.0,9,1610,340,47.6078,2040
6328,4,3.5,4490,2.0,9,3390,1100,47.5389,4410
6329,3,2.75,1740,1.0,7,1740,0,47.1941,2380
6330,4,2.25,1800,2.0,8,1800,0,47.5167,1650
6331,5,2.5,2406,2.0,8,2406,0,47.2615,1767
6332,5,2.75,2920,2.0,8,2920,0,47.4935,2520
6333,3,2.25,1450,2.0,7,1450,0,47.367,1660
6334,5,3.5,4230,2.0,10,4230,0,47.5933,3000
6335,3,3.5,3690,2.0,10,3690,0,47.5402,3690
6336,4,3.25,1690,2.0,8,1320,370,47.678,3080
6337,4,2.5,1890,2.0,8,1890,0,47.343,2720
6338,2,1.5,1100,3.0,8,1100,0,47.6584,1110
6339,4,4.25,4500,2.0,11,2630,1870,47.559,3030
6340,4,3.25,3780,1.0,11,2240,1540,47.5508,3120
6341,4,3.0,5940,2.0,11,4950,990,47.5443,4240
6342,3,3.0,1670,1.0,7,1670,0,47.1948,1670
6343,5,2.75,3370,2.0,9,3370,0,47.4893,3010
6344,3,2.25,1620,3.0,8,1620,0,47.6051,1560
6345,3,1.75,1300,2.0,7,840,460,47.5677,1340
6346,3,3.0,1730,3.0,8,1730,0,47.6944,1830
6347,3,2.5,1260,3.0,8,1260,0,47.6969,1270
6348,4,2.5,1934,2.0,8,1934,0,47.2602,1919
6349,3,1.5,1220,3.0,8,1220,0,47.674,1510
6350,3,2.0,1280,2.0,9,1040,240,47.602,1280
6351,2,2.5,1590,2.0,8,1590,0,47.5441,1590
6352,3,2.5,2870,2.0,9,2870,0,47.7745,2870
6353,4,4.5,4040,2.0,9,3220,820,47.7067,3940
6354,3,2.5,1660,2.0,7,1660,0,47.5298,1670
6355,2,1.75,910,1.0,6,910,0,47.3494,1310
6356,4,2.75,3540,2.0,9,3540,0,47.6181,3540
6357,3,3.5,3940,2.0,10,3940,0,47.438,2015
6358,4,2.5,2009,2.0,8,2009,0,47.2577,2009
6359,2,2.5,980,3.0,8,980,0,47.6844,980
6360,2,2.5,1470,3.0,8,1470,0,47.6523,1480
6361,3,2.5,2430,2.0,7,2430,0,47.5162,2620
6362,4,3.25,3060,2.0,10,2300,760,47.5311,2920
6363,3,3.25,1310,2.0,8,1060,250,47.6744,1160
6364,3,2.5,2370,2.0,8,2370,0,47.3699,2370
6365,3,2.25,1450,2.0,8,1140,310,47.6076,1580
6366,5,2.75,2980,2.0,9,2980,0,47.7698,2850
6367,3,2.5,1860,2.0,8,1860,0,47.3557,2000
6368,3,2.5,1509,3.0,8,1509,0,47.7049,1509
6369,2,1.5,1010,3.0,7,1010,0,47.7124,1128
6370,5,3.5,4495,2.0,9,3580,915,47.7339,4495
6371,3,2.5,1580,3.0,9,1580,0,47.6276,1610
6372,4,2.25,1890,2.0,7,1890,0,47.5493,1630
6373,3,2.25,1320,2.0,7,1040,280,47.5199,1300
6374,4,2.5,2150,2.0,8,2150,0,47.3363,2150
6375,2,2.5,1950,2.0,9,1500,450,47.5622,1800
6376,5,4.0,3040,2.0,8,2280,760,47.5189,3070
6377,5,3.5,2640,2.0,7,2640,0,47.5298,2640
6378,5,4.0,5190,2.0,11,5190,0,47.6102,3840
6379,4,2.5,1987,2.0,7,1987,0,47.2679,1880
6380,1,1.0,720,1.0,6,720,0,47.5811,1140
6381,4,2.5,2500,2.0,9,2500,0,47.5185,2760
6382,5,3.5,3230,2.0,10,3230,0,47.6467,3230
6383,3,2.5,2700,2.0,9,2700,0,47.5618,3270
6384,4,3.5,3830,2.0,9,3830,0,47.7049,3640
6385,5,3.0,3190,1.0,9,1890,1300,47.50899999999999,2270
6386,3,2.25,1490,2.0,7,1490,0,47.7607,1750
6387,4,2.5,3020,2.0,9,3020,0,47.773,3240
6388,4,2.5,2390,2.0,7,2390,0,47.5353,2520
6389,4,2.5,2090,2.0,8,2090,0,47.3595,2160
6390,3,2.5,1960,2.0,7,1670,290,47.4873,1980
6391,5,3.5,2738,2.0,8,2738,0,47.2962,2738
6392,3,2.5,1650,2.0,8,1650,0,47.5336,1800
6393,4,2.5,3040,2.0,9,3040,0,47.3473,2640
6394,3,1.5,1190,2.0,8,920,270,47.6781,2820
6395,4,2.5,3753,2.0,10,3336,417,47.3011,3494
6396,5,3.5,3440,2.0,9,3440,0,47.4765,3270
6397,2,2.25,1240,2.0,7,1150,90,47.5321,1240
6398,2,1.5,1160,2.0,8,1020,140,47.6754,1210
6399,3,3.25,1480,2.0,8,1180,300,47.5556,1330
6400,5,3.25,2910,2.0,8,2040,870,47.5543,2910
6401,3,2.5,1280,3.0,8,1280,0,47.662,1450
6402,4,2.5,1983,2.0,9,1983,0,47.3281,2502
6403,3,3.25,2440,2.0,8,1710,730,47.5362,2440
6404,3,2.25,1260,2.0,7,1260,0,47.5482,1630
6405,3,2.5,2000,2.0,8,2000,0,47.7713,2210
6406,5,3.25,3480,2.0,9,3480,0,47.607,3360
6407,5,2.75,2880,2.0,9,2880,0,47.4893,3010
6408,5,4.0,4100,2.0,9,4100,0,47.6917,4100
6409,3,2.25,1620,3.0,8,1540,80,47.5396,1390
6410,2,2.5,1380,2.0,7,1140,240,47.5441,1580
6411,3,2.5,1610,2.0,8,1610,0,47.771,2210
6412,3,2.0,1824,1.0,9,1824,0,47.3457,2409
6413,4,3.25,4140,2.0,10,4140,0,47.5707,2150
6414,4,3.5,3460,2.0,10,3460,0,47.5942,3380
6415,4,2.5,1954,2.0,8,1954,0,47.2606,1934
6416,4,3.0,2650,2.0,8,2650,0,47.7734,2380
6417,3,2.5,1910,2.0,9,1910,0,47.5481,1910
6418,3,1.75,1300,2.0,7,1060,240,47.539,1350
6419,4,2.5,1880,2.0,8,1880,0,47.5636,1890
6420,3,3.25,1550,2.0,9,1220,330,47.6493,1550
6421,4,3.75,2890,2.0,9,2240,650,47.676,2354
6422,3,1.75,1370,3.0,9,1370,0,47.6434,1730
6423,4,3.25,2510,2.0,9,2510,0,47.5028,1590
6424,3,2.5,1710,2.0,8,1710,0,47.5787,1640
6425,2,2.5,1310,2.0,8,1160,150,47.6112,1320
6426,3,1.5,1680,1.5,7,1680,0,47.6923,1990
6427,3,2.0,1330,2.0,8,1060,270,47.5522,1440
6428,3,2.5,1550,2.0,7,1550,0,47.3528,2095
6429,4,2.5,2550,2.0,8,2550,0,47.5355,2850
6430,3,2.5,1300,3.0,8,1300,0,47.6607,1450
6431,1,1.5,1170,2.0,8,1070,100,47.5493,1360
6432,4,3.5,4170,2.0,9,3500,670,47.7726,3510
6433,4,3.25,2864,3.0,8,2864,0,47.3746,2419
6434,3,2.25,1630,2.0,7,1630,0,47.5485,1630
6435,5,2.5,3410,2.0,9,3410,0,47.5459,2810
6436,4,2.5,2632,2.0,8,2632,0,47.3428,2040
6437,3,2.5,2310,2.0,8,2310,0,47.7734,2440
6438,3,2.5,1770,3.0,8,1770,0,47.6532,1720
6439,3,2.0,1670,1.0,7,1670,0,47.1948,1670
6440,4,2.5,3520,2.5,9,2650,870,47.5317,2930
6441,3,2.25,1580,3.0,8,1580,0,47.5578,1250
6442,4,2.5,1867,2.0,9,1867,0,47.3524,2616
6443,2,1.75,1110,2.0,8,1110,0,47.5647,1420
6444,3,3.25,1560,2.0,8,1260,300,47.5637,1560
6445,4,4.75,4150,3.0,9,4150,0,47.7047,3570
6446,2,1.5,1090,3.0,8,1090,0,47.7235,1090
6447,4,2.5,1914,2.0,8,1914,0,47.4297,1714
6448,3,2.75,2470,2.0,9,2470,0,47.5406,2570
6449,4,3.5,2660,2.0,8,1920,740,47.4775,2970
6450,5,2.75,3010,2.0,9,3010,0,47.6067,3230
6451,4,2.5,1613,2.0,7,1613,0,47.3859,1427
6452,2,1.5,1160,2.0,7,970,190,47.6608,1700
6453,3,1.0,1150,1.0,7,1150,0,47.4262,1714
6454,2,2.25,1240,2.0,7,1150,90,47.5322,1260
6455,2,2.5,1640,2.0,10,1640,0,47.5639,1820
6456,3,2.5,1650,2.0,7,1520,130,47.5634,1520
6457,2,2.5,1680,3.0,9,1680,0,47.632,1680
6458,5,3.5,3420,2.0,8,2700,720,47.5162,2710
6459,3,2.75,2300,2.0,8,1700,600,47.545,1530
6460,4,3.5,4680,2.0,10,3040,1640,47.6984,3240
6461,4,2.5,2280,2.0,7,2280,0,47.3586,2630
6462,3,2.5,1440,3.0,8,1440,0,47.6995,1440
6463,4,3.5,2840,3.0,8,2840,0,47.7033,1730
6464,1,1.0,390,1.0,6,390,0,47.6938,1340
6465,2,2.25,1260,2.0,7,1170,90,47.5323,1240
6466,2,1.0,894,2.0,7,894,0,47.6911,1131
6467,3,2.25,1250,3.0,8,1250,0,47.6907,1250
6468,3,2.5,2000,2.0,7,2000,0,47.4937,2230
6469,4,2.75,3050,2.0,8,3050,0,47.4857,2730
6470,3,2.25,1720,2.0,9,1240,480,47.5547,1720
6471,3,2.5,2510,2.0,8,2510,0,47.6987,2520
6472,4,2.5,3390,2.0,8,3390,0,47.4536,1960
6473,4,2.5,2280,2.0,7,2280,0,47.3593,2910
6474,3,2.0,1230,1.0,7,1230,0,47.438,1440
6475,3,2.75,3160,2.0,9,3160,0,47.5147,3160
6476,4,3.75,4350,2.0,10,4350,0,47.6289,2190
6477,3,3.25,1290,3.0,7,1290,0,47.6904,1290
6478,5,3.5,4460,3.0,10,3280,1180,47.6313,2490
6479,4,2.5,2650,2.0,8,2650,0,47.4786,2650
6480,3,2.5,2540,2.0,7,2540,0,47.3358,2280
6481,3,2.5,1980,2.0,7,1980,0,47.3682,1980
6482,3,2.25,1900,2.0,7,1900,0,47.4866,1950
6483,3,1.75,1290,2.0,7,1060,230,47.54,1370
6484,4,2.75,3140,2.0,9,3140,0,47.5923,3500
6485,3,1.75,1420,3.0,8,1420,0,47.6625,1380
6486,3,3.0,1560,3.0,8,1560,0,47.6604,1530
6487,4,2.75,2810,2.0,9,2810,0,47.7081,2990
6488,2,2.25,1630,2.0,10,1330,300,47.6113,1570
6489,5,3.25,2850,2.0,8,2370,480,47.4916,2850
6490,3,2.5,2230,2.0,8,2230,0,47.73,2230
6491,4,3.5,2490,2.0,9,1780,710,47.5499,1710
6492,3,2.5,2670,2.0,9,2670,0,47.51,3040
6493,2,2.5,1430,3.0,8,1410,20,47.6683,1620
6494,3,2.5,1970,2.0,7,1970,0,47.5158,2710
6495,3,2.0,1980,3.0,8,1980,0,47.5524,1440
6496,3,2.5,2010,2.0,9,1610,400,47.5573,1660
6497,3,1.5,1270,3.0,8,1270,0,47.6989,1270
6498,4,2.5,3950,3.0,10,3950,0,47.5818,3200
6499,3,2.5,1420,3.0,7,1420,0,47.6904,1420
6500,4,3.5,2630,2.0,10,2200,430,47.5322,2620
6501,3,3.25,1340,3.0,7,1340,0,47.6904,1290
6502,3,2.75,1320,3.0,8,1320,0,47.6598,1320
6503,4,2.5,3120,2.0,9,3120,0,47.2779,3120
6504,3,2.25,1630,3.0,8,1630,0,47.6904,1320
6505,5,3.5,5230,2.0,11,4450,780,47.5964,2310
6506,5,2.5,2170,2.0,8,2170,0,47.5167,1800
6507,4,3.25,3610,2.0,9,2640,970,47.658,1980
6508,3,2.75,3230,2.0,9,2680,550,47.519,3100
6509,2,2.5,1460,2.0,8,1160,300,47.5923,1460
6510,3,2.5,1750,3.0,9,1750,0,47.5532,1750
6511,5,4.0,4590,2.0,10,4590,0,47.6647,3350
6512,4,4.0,4620,2.0,10,4620,0,47.5885,4620
6513,4,2.75,3220,2.0,8,3220,0,47.4863,2820
6514,3,1.75,2340,1.0,10,2340,0,47.4593,3040
6515,3,2.5,1910,3.0,8,1910,0,47.7634,1910
6516,3,4.5,3850,2.0,10,3120,730,47.6735,2630
6517,4,2.5,3040,2.0,8,3040,0,47.6788,3040
6518,3,1.75,1496,2.0,8,1248,248,47.715,1460
6519,5,6.5,7270,2.0,12,6420,850,47.5371,1800
6520,3,2.5,1350,3.0,8,1270,80,47.5491,1350
6521,4,2.5,2940,2.0,9,2940,0,47.3444,2660
6522,4,2.5,2790,2.0,8,2790,0,47.4959,2790
6523,3,3.25,1380,3.0,8,1380,0,47.6617,1310
6524,4,4.0,4920,2.0,10,4280,640,47.6575,4920
6525,6,3.0,2390,2.0,7,2390,0,47.5173,1680
6526,3,2.25,1610,2.0,7,1610,0,47.3589,1610
6527,3,2.5,1750,3.0,8,1750,0,47.6021,1940
6528,3,2.0,1060,2.0,7,730,330,47.5443,1270
6529,3,2.5,2100,2.0,9,2100,0,47.5983,1780
6530,4,2.5,2531,2.0,8,2531,0,47.385,2604
6531,3,2.25,998,2.0,7,798,200,47.6983,998
6532,3,2.5,2140,2.0,8,1960,180,47.537,2280
6533,3,2.5,3030,2.0,8,3030,0,47.4945,3010
6534,2,1.5,2370,2.0,11,2370,0,47.4543,3860
6535,1,1.25,1100,3.0,9,1100,0,47.6228,1110
6536,5,4.0,4500,2.0,10,4500,0,47.4832,2840
6537,5,2.75,3080,2.0,9,3080,0,47.4922,3000
6538,4,3.0,1670,2.0,8,1350,320,47.6397,1670
6539,3,2.5,1450,1.0,7,840,610,47.5435,2120
6540,4,3.5,2850,2.0,8,1950,900,47.5252,2850
6541,4,3.5,3070,2.0,10,2190,880,47.5316,2290
6542,3,2.5,3087,2.0,8,3087,0,47.2974,2927
6543,4,3.25,1900,2.0,9,1250,650,47.5869,1710
6544,2,1.5,940,2.0,7,940,0,47.5925,1130
6545,3,3.25,1730,2.0,9,1320,410,47.6374,1710
6546,3,3.0,2780,2.0,9,2780,0,47.5184,2850
6547,3,3.0,2780,2.0,9,2780,0,47.5184,2850
6548,3,2.5,1260,2.0,7,940,320,47.5621,1310
6549,3,2.5,2540,2.0,8,2540,0,47.3452,2540
6550,4,2.75,2770,2.0,8,2770,0,47.5001,1810
6551,3,2.25,1190,3.0,8,1190,0,47.6542,1180
6552,5,3.75,4470,2.0,11,4470,0,47.6321,2780
6553,3,2.0,1490,3.0,8,1490,0,47.5699,1400
6554,2,0.75,1020,2.0,7,1020,0,47.5944,1020
